日语一级至四级级词汇表																
汉字	假名(读音)	词性	词义
ああ	ああ	副，感	那样，啊
愛	あい	名	慈爱；（对异性的）爱情；爱好
藍	あい	名	蓝色
相容れない	あいいれない	形	不一致；不融洽
相打つ，相搏つ	あいうつ	自五	搏斗；激战
愛煙家	あいえんか	名	喜欢吸烟的人
哀歌	あいか	名	哀歌；悲歌
合鍵	あいかぎ	名	配制的钥匙
相方	あいかた	名	对方；顾客、客户；对象、对手
相変わらず	あいかわらず	副	照旧、仍旧
哀願	あいがん	名，サ変	哀求、恳求
愛玩	あいがん	名，サ変	玩赏、欣赏；宠物、玩赏品
愛嬌	あいきよう	名	和蔼、可爱、动人之处
愛犬	あいけん	名	爱犬
愛顧	あいこ	名，サ変	爱顾、惠顾
愛護	あいご	名，サ変	爱护、爱惜
愛好	あいこう	名，サ変	爱好
愛国	あいこく	名	爱国
合言葉	あいことば	名	暗语；标语
愛妻	あいさい	名	爱妻、爱妻子
挨拶	あいさつ	名，サ変	点头；致词；寒暄、问候
愛児	あいじ	名	爱子
愛着	あいじゃく,あいちゃく	名，サ変	眷恋、不能忘怀
哀愁	あいしゅう	名	哀愁
愛称	あいしょう	名	爱称
相性	あいしょう	名	男女、主仆、朋友之间投缘
愛情	あいじょう	名	热情；爱情
愛人	あいじん	名	情人（情夫、情妇）
合図	あいず	名，サ変	暗号、信号
愛する	あいする	サ変	疼爱；喜好
愛惜	あいせき	名，サ変	爱惜；珍惜
愛想	あいそ	名	和蔼、亲切；好感；招待；算账
間	あいだ	名	间隔、期间；中间
間柄	あいだがら	名	关系、交情
哀調	あいちょう	名	悲调
相次ぐ，相継ぐ	あいつぐ	子午	相继发生
相槌	あいづち	名	随声附和
相手	あいて	名	伙伴；对方、对手
哀悼	あいとう	名，サ変	哀悼
愛読	あいどく	名，サ変	爱读、好读
生憎	あいにく	形動，副	不凑巧、偏巧
愛撫	あいぶ	名，サ変	爱抚
愛慕	あいぼ	名，サ変	爱慕
曖昧	あいまい	形動	含糊、暧昧；可疑、不正当的
相俟って	あいまって	副	相结合、相辅
愛用	あいよう	名，サ変	爱用、常用
愛欲	あいよく	名	爱欲、情欲
会う	あう	自五	会面、见面
逢う	あう	自五	偶然碰见
合う	あう	自五，補助	一致、符合；互相
遭う，遇う	あう	自五	遇到、遭遇
喘ぐ	あえぐ	自五	喘息、挣扎
敢えて	あえて	副	强行、斗胆；未必、不必
和える	あえる	他下一	（用盐、醋、酱和芝麻等）拌食品
亜鉛	あえん	名	锌
青い	あおい	形	青色、蓝色、绿色；不成熟
葵	あおい	名	葵、葵类植物总称
蒼い	あおい	形	脸色不好
仰ぐ	あおぐ	他五	仰视；尊敬；依靠、仰仗；一口气喝完
扇ぐ	あおぐ	他五	扇风
煽ぐ	あおぐ	他五	煽动
青臭い	あおくさい	形	有青草味；不成熟的
青写真	あおじゃしん	名	设计图；计划
青白い，蒼白い	あおじろい	形	脸色苍白、无血色
青信号	あおしんごう	名	绿灯
青空	あおぞら	名	碧空；室外、露天
青田	あおた	名	青苗地
青田刈り	あおたがり	名	割青苗；敲定、录用在校学生
青菜	あおな	名	青草、青菜
青二才	あおにさい	名	毛孩子（用于贬义）
仰向く	あおむく	自五	仰面；仰起
煽り	あおり	名	（暴风的）冲击；牵累、余波；煽动
煽る	あおる	塔五	煽动；哄抬
垢	あか	名	污垢；水垢
赤	あか	名	红色；完全
赤い	あかい	形	红色的；共产主义的
足掻く	あがく	自五	（马用前蹄）刨地；挣扎；焦躁
赤字	あかじ	名	红笔字；亏损、赤字
赤信号	あかしんごう	名	红灯；危险信号、警告
飽かす	あかす	他五	令人厌腻；不吝啬、充分使用
明かす	あかす	他五	过夜；证明；道破、透露
赤ちゃん	あかちゃん	名	婴儿
暁	あかつき	名	黎明；……实现之时
明かり	あかり	名	光线；灯光
上がる	あがる	自五，補助	上、登、升；提高、长进；（谦语）去；结束、完成；怯场；（敬语）吃、喝；做好；完全
揚がる	あがる	自五	炸好
明るい	あかるい	形	明亮的；开朗、活泼的；通晓
空き	あき	名	空闲；缺编、空缺
秋	あき	名	秋天
飽き，厭き	あき	名	厌、腻
空き巣	あきす	名	空窝；空宅、空房子
商う	あきなう	他五	经商
明らか	あきらか	形動	明亮；明显、显然、确切
諦める	あきらめる	他下一	放弃、死心
飽きる	あきる	自上一	厌烦
呆れる	あきれる	自下一	吃惊、发呆；厌烦
開く，明く	あく	自五	开
空く	あく	自五	有空隙；闲着；缺编
悪	あく	名	坏、恶
悪意	あくい	名	恶意；怀的意思；（法）明知故犯
悪質	あくしつ	名，形動	恶劣；质量不好
握手	あくしゅ	名，サ変	握手、协作
悪臭	あくしゅう	名	恶臭、难闻的气味
悪習	あくしゅう	名	恶习
悪循環	あくじゅんかん	名	恶性循环
悪性	あくせい	名，形動	恶性、指病难痊愈
あぐねる	あぐねる	自下一	厌、烦、腻（多接在动词连用形之后）
欠伸	あくび	名	哈欠
あくまで	あくまで	副	到底、彻底、始终
悪名	あくめい	名	名声不好
悪用	あくよう	名，サ変	滥用
明くる	あくる	連体	下、此、翌
明け方	あけがた	名	黎明
揚げ句	あげく	名	日本的连歌或俳句的最后一句；最终
開ける	あける	他下一	打开（门、包装等）
明ける	あける	他下一	天明；过年；期满、结束
空ける	あける	他下一	空出；腾出；不在家
挙げる	あげる	他下一	举；举出；举行；发动；扬（名）
上げる	あげる	他下一	举起、拎起；进房间；升学；进步、提高；增加数量、加深程度；得益；完成；显效；送给；出声
揚げる	あげる	他下一	举起；油炸；起（货）
顎	あご	名	下巴
憧れる	あこがれる	自下一	向往、憧憬；被异性所吸引
朝	あさ	名	早上、上午
麻	あさ	名	麻、麻布
痣	あざ	名	痣
浅い	あさい	形	浅；（时间等）短；肤浅、少的；颜色淡
嘲る	あざける	他五	愚弄、嘲笑
明後日	あさって	名	后天
朝寝坊	あさねぼう	名，サ変	早上睡懒觉（的人）
朝晩	あさばん	名，副	早晚
朝日	あさひ	名	朝日
浅ましい	あさましい	形	悲惨；卑鄙的
欺く	あざむく	他五	欺骗；赛过、胜似
鮮やか	あざやか	形動	鲜明；出色
足	あし	名	脚、腿、（器物的）腿儿
葦	あし	名	芦苇
味	あじ	名	味道、风味；滋味、甜头；趣味、情调
足跡	あしあと	名	脚印；总计；业绩、成就
足音	あしおと	名	脚步声
足掛かり	あしがかり	名	脚手架、登高时的踏脚处；线索、头绪
味気ない	あじきない	形	乏味的、无聊的
明日	あした	名	明天
足手まとい	あしてまとい	名，形動	累赘
足取り	あしどり	名	脚步、步伐；踪迹；行情、动态
足並み	あしなみ	名	步伐；步调
足場	あしば	名	脚手架；立足点；交通之便
足踏み	あしぶみ	名，サ変	原地踏步；停滞
足元	あしもと	名	立脚点、基础；身旁、左右
あしらう	あしらう	他五	招待、应付；冷淡对待；点缀、配
味わう	あじわう	他五	品尝；玩味、欣赏；体验
明日	あす	名	明天
預かる	あずかる	他五	收存、保管；照顾；承担、担任
与る	あずかる	自五	参与；蒙受（夸奖、好处）
預ける	あずける	他下一	寄存；托付、委托
汗	あせ	名	汗；水滴
汗ばむ	あせばむ	自五	出汗
汗疹	あせも	名	痱子
焦る	あせる	自五	着急、焦躁
褪せる	あせる	自下一	褪色；衰退
あそこ	あそこ	代	那里；那种地步；那种程度；那一点
遊ばす	あそばす	他五	让……玩；闲置
遊ぶ	あそぶ	自五	玩耍；旅行、游学；没工作；不起作用
仇	あだ	名	仇人；仇恨；危害
徒	あだ	名，形動	徒然、白费
価	あたい	名	（商品等的）价格；价值
値	あたい	名	数学值
与える	あたえる	他下一	授予；给予；使蒙受
あたかも	あたかも	副	宛如；正值
暖かい，温かい	あたたかい	形	温暖；和睦；富足
暖まる，温まる	あたたまる	自五	变热；感到温暖
暖める，温める	あたためる	他下一	加热；孵蛋；珍藏、重温；悄悄地据为己有
渾名，綽名	あだな	名	小名、外号
頭	あたま	名	头
頭金	あたまきん	名	定金、押金
新しい	あたらしい	形	新的；新式的；新鲜的、有活力的；现代的、进步的
辺り	あたり	名	周围；大约；之类的
当たり前	あたりまえ	形動	当然；普通
当たる	あたる	自五	晒（太阳）；吹（风）等；顺利、成功；击中、命中、猜队；粗暴对待；承担、担任；对抗；被指名；查探；查、对照；相当于；（与否定连用表示）没必要
あちこち	あちこち	代	到处；顺序乱
あちら	あちら	代，名	那边；那个；那位
熱い	あつい	形	温度高；体温高、热烈的
暑い	あつい	形	气温高
厚い	あつい	形	有厚度；人情深厚；程度很深
篤い	あつい	形	病重；志笃、（感情）深厚
悪化	あっか	名，サ変	（人的品行、事物状态等）变坏、恶化
扱う	あつかう	他五	操作；对待、待遇；处理；出售；报道
厚かましい	あつかましい	形	无耻、脸皮厚
呆気ない	あっけない	形	（内容等）过于简单、未尽兴
あっさり	あっさり	副	清淡；轻易
圧縮	あっしゅく	名，サ変	加压；压缩
斡旋	あっせん	名，サ変	斡旋、调停；介绍
あっという間に	あっというまに	連語	转眼功夫、一瞬间
圧倒	あっとう	名，サ変	压倒
圧迫	あっぱく	名，サ変	压迫感；威压、压制
集まる	あつまる	自五	集合、聚集；收集；集中
集める	あつめる	他下一	使集合；收集、征集；集中、吸引
誂える	あつらえる	他下一	定做、点菜
圧力	あつりょく	名	压力；威压
当て	あて	名	目的、目标；指望；信用、信赖
当てつける	あてつける	他下一	指桑骂槐；炫耀关系好
宛て名	あてな	名	收信（件）人姓名和地址
当てはまる	あてはまる	自五	适用、合适
当てはめる	あてはめる	他下一	适用；套用
当てる	あてる	他下一	碰撞；命中；晒；紧靠；中（奖）；猜对、预测正确；指名、委派
充てる	あてる	他下一	充当
後	あと	名	后面；后方；以后；之后；那么、再见；（顺序）后；死后；后任、后继者、续弦；剩下的；其后、还有
跡	あと	名	（猎物等的）痕迹；印记；遗迹、遗物、废墟等；继任、继承家业
後味	あとあじ	名	余味；回味
後先	あとさき	名	先后、顺序；前因后果
後始末	あとしまつ	名，サ変	善后处理
跡継ぎ，後継ぎ	あとつぎ	名	后代；后任、接班人
跡取	あととり	名	继承人
後払い	あとばらい	名，サ変	后付款、赊账
穴孔	あな	名	洞、穴；亏空
強ち	あながち	副	未必
貴方	あなた	代	你、您
侮る	あなどる	他五	侮辱、轻视
兄	あに	名	哥哥
姉	あね	名	姐姐；嫂子
あの	あの	連体	那个（远称）；那
暴く	あばく	他五	揭发；发掘
痘痕	あばた	名	麻子
暴れる	あばれる	自下一	胡闹；闯荡
浴びせる	あびせる	他下一	浇、泼（水等）；使蒙受、遭受；不断地质问、非难
浴びる	あびる	他上一	洗、淋浴、泼；沐浴；受到非难、质问、赞扬等
危ない	あぶない	形	危险的；垂危；不稳定、不确定；靠不住；危急、千钧一发
油，脂	あぶら	名	油
脂，膏	あぶら	名	脂肪
焙る，炙る	あぶる	他五	取暖、烘干；烤
溢れる	あふえる	自下一	溢、慢；形容人很多；充满、洋溢
あべこべ	あべこべ	形動	相反、颠倒
阿呆	あほう	名，形動	蠢；傻子
甘い	あまい	形	甜；淡、咸味不足；指声音甜；不严格、宽松；考虑简单、浅薄、天真；男女关系好；松弛；钝
甘える	あまえる	自下一	撒娇；承蒙
雨具	あまぐ	名	雨具
余す	あます	他五	剩下；剩
遍く	あまねく	副	到处、普遍
余り	あまり	名，副，接尾	剩余；过分；太、很；不怎么；余、多
余りに	あまりに	副	非常、太、很
余る	あまる	自五	剩、余；胜过
網	あみ	名	网；罗网
編む	あむ	他五	编织；编纂
雨	あめ	名	雨、雨点般
飴	あめ	名	饴糖
綾，文	あや	名	花纹、斜纹；条理、理由；修辞
怪しい	あやしい	形	奇怪的；可疑的、难以置信的；靠不住的、不确定的；要变坏的
怪しむ	あやしむ	他五	怀疑、觉得奇怪
操る	あやつる	他五	耍（木偶）；熟练的掌握、运用；驾驭、操纵
あやふや	あやふや	形動	含糊；靠不住
過ち	あやまち	名	失败、错；过失
誤る	あやまる	他五	错、弄错；耽误、贻误
謝る	あやまる	他五	认错
歩み寄る	あゆみよる	自五	接近、靠近；妥协、让步
歩む	あゆむ	自五	步行；前进、进展
荒い	あらい	形	粗暴；剧烈；胡来
粗い	あらい	形	粗、大；粗糙
洗う	あらう	他五	洗；洗刷、冲洗；调查、查清
嵐	あらし	名	暴风雨；纠纷、困难
荒らす	あらす	他五	使乱七八糟、使荒芜；骚扰、偷盗
粗筋	あらすじ	名	梗概
争う	あらそう	他五	竞争；争吵、争论；主张、申辩
改まる	あらたまる	自五	更新；变好；郑重、客气
改めて	あらためて	副	稍后；再次
改める	あらためる	他下一	更新、改；改正；语言、态度等郑重；调查、计算
あらゆる	あらゆる	連体	所有、一切
現す	あらわす	他五	使其出现；发挥
著す	あらわす	他五	撰写、著
表わす	あらわす	他五	表露；表现；意味着
現れる	あらわれる	自下一	显露；出现；来
表れる	あらわれる	自下一	露出、呈现
蟻	あり	名	蚂蚁
ありありと	ありありと	副	清清楚楚地、活生生地
有り合わせ	ありあわせ	名	现有、现成
在り方	ありかた	名	存在的状态；应有的状态、理想的状态
有り難い	ありがたい	形	宝贵的；难得、感激
ありがとう	ありがとう	感	谢谢
有様	ありさま	名	状态、状况、形式
在る	ある	自五	存在、活着；位于
有る	ある	自五	具备、有；举行；发生；有果、经历；有（数量）；用“……してある”的形式表示行为的完成；用“……である”的形式表示断定
或る	ある	連体	某
或いは	あるいは	接	或者；用于列举同类事项；也许
歩く	あるく	自五	步行；外出
主	あるじ	名	主人、店主；持有者
あれ	あれ	代，感	那个；那件事；那时；那个人；那儿；哎呀
荒れる	あれる	自下一	海浪汹涌；荒废、荒芜；皮肤变粗糙、皴裂；行为、秩序等杂乱无章
泡	あわ	名	泡沫
淡い	あわい	形	颜色浅、味道淡；微少的
合わせる，併せる	あわせる	他下一	合并；相加、合计；调整机械、乐器；适应；切合；核对；使一致、配合；混合
慌ただしい	あわただしい	形	不稳定的；慌忙、匆忙
慌てる	あわてる	自下一	着慌、慌忙
哀れ	あわれ	名	可怜、怜悯；情趣、情感
案	あん	名	计划、提案；想法、意见；预想、意料
安易	あんい	形動	容易；马马虎虎的
案外	あんがい	形動，副	意外的（地）
暗記	あんき	名，サ変	背诵
暗号	あんごう	名	暗号
暗殺	あんさつ	名，サ変	暗杀
暗算	あんざん	名，サ変	心算
暗示	あんじ	名，サ変	暗示
暗礁	あんしょう	名	暗礁
案じる	あんじる	他上一	想办法；担心
安心	あんしん	名，サ変，形動	安心、放心
安静	あんせい	形動，名	静养
安全	あんぜん	名，形動	安全
安定	あんてい	名，サ変	安定、稳定
案内	あんない	名，サ変	引导；通知；直到、了解
塩梅	あんばい	名	咸淡、口味；光景、状态；身体状况
安否	あんぴ	名	是否平安
安眠	あんみん	名，サ変	安眠
安楽	あんらく	名，形動	安乐、舒服
胃	い	名	胃
良い，好い	いい	形	好；适合；行、可以；最好、希望；容易
言い返す	いいかえす	他五	顶嘴、还口
言い換える	いいかえる	他下一	换个说法
いい加減	いいかげん	名，副，形動	适度地；无根据、不负责任；很、相当
言い損なう	いいそこなう	他五	说错、失言；（该说而）没说、忘说
言いつける	いいつける	他下一	命令；告状
言い直す	いいなおす	他五	改口、重说
許嫁	いいなずけ	名	小时父母定的婚约；未婚夫（妻）
言い残す	いいのこす	他五	留话；遗言
言い訳	いいわけ	名	辩解、解释
医院	いいん	名	（私人）诊所、（小规模）医院
委員	いいん	名	委员
言う	いう	自，他五	说；有声响；询问；批评、评价；表达；叫、称做；议论、谣言；美言、讲情
家	いえ	名	房子；家；门第
家柄	いえがら	名	门第、家世
硫黄	いおう	名	硫磺
以下	いか	名	（数量、程度等）以下；下面
以外	いがい	名	（除了……）之外
意外	いがい	形動	意外的（地）
如何	いかが	副，形動	怎样、如何
医学	いがく	名	医学
生かす	いかす	他五	使活着；使用；使复活
如何に	いかに	副	怎样；多么、怎么
いかにも	いかにも	副	真的、的确；诚然、果然
厳しい	いかめしい	形	庄严、威严
錨	いかり	名	锚
怒る	いかる	自五	生气；挺起、耸起
遺憾	いかん	名，形動	遗憾
息	いき	名	呼吸；步调；喘不上气来
粋	いき	形動	洋气、气质不凡；通晓人情
意気	いき	名	意气；精神、气势
異議	いぎ	名	异议、抗议
意義	いぎ	名	意义；重要的、有意义的
生き生き	いきいき	副	生气勃勃、新鲜地
勢い	いきおい	名	力；活力、生气；劲头、情况；势力
生き甲斐	いきがい	名	生存的意义
生き返る	いきかえる	自五	复活；恢复精神、记忆
息切れ	いきぎれ	名，サ変	气喘；（工作等）中途停止
意気込み	いきごみ	名	干劲、热情
経緯	いきさつ	名	（事件的）经过；（事物的）内情
行き過ぎる	いきすぎる	自上一	通过；过分
行き違い	いきちがい	名	错过；分歧、不一致
行き詰まる	いきづまる	自五	走到尽头；事物进展不顺利
行き届く	いきとどく	自五	周到
いきなり	いきなり	副	突然、冷不防
息抜き	いきぬき	名，サ変	稍作休息、散心
生き残る	いきのこる	自五	幸存
生き物	いきもの	名	活物、生物
生きる	いきる	自上一	谋生、维持生计；有效、有影响；生动、栩栩如生
行く	いく	自五	去；寄到；过去、逝去；往来、上班、上学；事情进展；以某种方式作；满足
幾つ	いくつ	名	几个；几岁
幾ら	いくら	名	多少、多少钱；无论如何、即使也
幾度	いくど	副	几回；几度
池	いけ	名	池子、水池；砚池
いけない	いけない	形	不好的、不行的；没有希望的、没有指望的；禁止
生ける	いける	他下一	插花；栽花
意見	いけん	名，サ変	想法；忠告、建议
威厳	いげん	名	威严
以後	いご	名	以后
囲碁	いご	名	围棋
憩い	いこい	名	休息
移行	いこう	名，サ変	转移、过度
意向	いこう	名	意图、愿望
潔い	いさぎよい	形	坦率、勇敢；干脆
聊か，些か	いささか	副	仅仅、很少
勇ましい	いさましい	形	勇敢的；大胆的；雄壮
諫める	いさめる	他下一	禁止、制止；劝告、谏告
遺産	いさん	名	遗产；（先人的）功绩
石	いし	名	石子；宝石
意志	いし	名	意志；意向
意思	いし	名	想法、打算
意地	いじ	名	气质、性情；固执、要强；物欲、食欲
遺児	いじ	名	遗腹子
維持	いじ	名，サ変	维持
意識	いしき	名	知觉；认识、觉悟到；意识
異質	いしつ	名	性质不同；相异性
苛める	いじめる	他下一	虐待；戏弄
医者	いしゃ	名	医生
衣装	いしょう	名	服装；盛装、戏装
異常	いじょう	名，形動	异常的、非同寻常的
以上	いじょう	名	上述；完、终；以上、既然
衣食	いしょく	名	衣食、生活
移植	いしょく	名，サ変	移植
いじらしい	いじらしい	形	可爱；令人怜爱
弄る	いじる	他五	抚弄、玩弄；玩味、摆弄；随意改动
意地悪	いじわる	名，形動	心眼坏的
椅子	いす	名	椅子；职位
泉	いずみ	名	泉、泉水；源泉
何れ,孰れ	いずれ	代，副	二者之中、多者之中、其中；归根结底、终归；不久、最近
威勢	いせい	名	威力、势力；精神、元气
異性	いせい	名	异性
以前	いぜん	名	以前、过去
依然	いぜん	副	依然
磯	いそ	名	海岸、湖滨
忙しい	いそがしい	形	忙碌
急ぐ	いそぐ	自他五	着急、赶紧；急、忙
遺族	いぞく	名	遗属
板	いた	名	板
遺体	いたい	名	遗体
痛い	いたい	形	疼痛；难受；（被触及弱点而）感到痛苦
偉大	いだい	形動	伟大
痛々しい	いたいたしい	形	悲惨、可怜
委託	いたく	名，サ変	委托
抱く	いだく	他五	抱；怀有、抱有
致す	いたす	他五	“する”的谦恭说法；引起
悪戯	いたずら	名，サ変，形動	恶作剧、淘气（的）
頂く，戴く	いただく	他五	顶、戴、顶在上面；领受、蒙……赐给；“食う、飲む”的谦恭说法；请、给
痛手	いたで	名	重伤、重创；沉重的打击
痛む，傷む	いたむ	自五	身体疼痛；心痛、伤心；损坏
炒める	いためる	他下一	炒
痛める	いためる	他下一	弄疼；令人痛苦
傷める	いためる	他下一	损坏；使食品腐烂
至る	いたる	自五	到、至；到（某时）；涉及到；结果为
労わる	いたわる	他五	照顾；慰劳
異端	いたん	名	异端、邪说
市	いち	名	市场
位置	いち	名	位置；地位
一一	いちいち	副	逐一；全部；详细
一応	いちおう	副	大体上；暂且
一概に	いちがいに	副	一概、无例外地
一時	いちじ	名，副	同时；瞬间；那时、过去；暂时；1点钟
著しい	いちじるしい	形	显著的、明显的
一族	いちぞく	名	同族
一段	いちだん	副	更加、越发
一度	いちど	名	一次
一同	いちどう	名	全部、全体
一日	いちにち	名	一天；一整天；某日
一人前	いちにんまえ	名	（食物）一份儿；成人、能顶一个人
市場	いちば	名	市场、集市
一番	いちばん	名，副	第一；最；最好
一部	いちぶ	名	一部分；一册、一卷
一面	いちめん	名	事物的一个方面；一面、全面；报纸头版
一目	いちもく	名	一眼
一覧	いちらん	名，サ変	一览；便览
一流	いちりゅう	名	一流、头等；独特
何時	いつ	代	何时
一家	いっか	名	一家
一気に	いっきに	副	一口气；一下子、疾速地
一見	いっけん	名，サ変，副	稍微一看；乍一看
一向	いっこう	副	完全、全然地；一点也不
一国	いっこく	名，形動	一刻、片刻；顽固的
一切	いっさい	名，副	一切；全然
一種	いっしゅ	名	一种
一瞬	いっしゅん	名	一瞬间
一緒	いっしょ	名	一起做；同时发生；在一起
一生	いっしょう	名	一生；生命
一心	いっしん	名	专心、齐心
逸する	いっする	サ変	失去、错过；脱离；忘记、落下
一線	いっせん	名	界线；第一线
いっそ	いっそ	副	索性、倒不如
一層	いっそう	副	更加
一体	いったい	名，副	一体、同心协力；总的来说、整体上；到底（表示强烈疑问）
一旦	いったん	副	一旦、既然；万一；姑且
一致	いっち	名，サ変	一致、调和；对应
一定	いってい	名，サ変	一定
いつの間にか	いつのまにか	副	不知不觉
一杯	いっぱい	名，副	一杯、一碗；饮少量的酒；满满的；全部、占满；极限；许多
一般	いっぱん	名	整个、普通；普通、一般
一歩	いっぽ	名	一步、一个阶段
一方	いっぽう	名，副助，接	一方面；（立场不同的双方中的）其中一方；一个劲儿地、一直；另一方面
いつも	いつも	副	经常地；平常
偽る	いつわる	他五	欺骗；说谎
遺伝	いでん	名，サ変	遗传
糸	いと	名	线；乐器的弦；钓鱼线；线状物
意図	いと	名，サ変	意图
井戸	いど	名	井
従兄弟	いとこ	名	堂兄弟（姐妹）、表兄弟（姐妹）
営む	いとなむ	動	从事；经营；营造
暇	いとま	名	闲暇、余暇；休假；解雇、辞职；告辞
挑む	いどむ	動	挑战；挑衅；挑逗
以内	いない	接尾	以内
田舎	いなか	名	乡下、地方上的；故乡
稲妻	いなずま	名	闪电；飞快
委任	いにん	名，サ変	委任
犬	いぬ	名	狗；间谍、鹰犬
稲	いね	名	水稻
命	いのち	名	生命；寿命；最重要的
祈る	いのる	他五	（向神佛）祈祷；祝愿、希望
威張る	いばる	自五	趾高气扬、自吹自擂
違反	いはん	名，サ変	违反
鼾	いびき	名	鼾声
訝しい	いぶかしい	形	可疑、奇怪
息吹	いぶき	名	呼吸；气息
衣服	いふく	名	衣服
違法	いはう	名	违法
今	いま	名，副	现在；当前；马上；正好、方才；用[今少しで]的形式，表示“几乎”
居間	いま	名	起居室
忌々しい	いまいましい	形	可恶、可恨
戒める	いましめる	他下一	训斥、警告；禁止
未だに	いまだに	副	还、仍然
意味	いみ	名	意思；动机；含义；主旨、要点；意义
芋	いも	名	薯的总称
妹	いもうと	名	妹妹
嫌	いや	形動	令人厌烦的
嫌がる	いやがる	自五	讨厌、厌恶
卑しい	いやしい	形	寒碜；卑鄙；卑贱；嘴馋
癒す	いやす	他五	治疗；解渴、充饥
いよいよ	いよいよ	副	越发；终于；果真、确实
意欲	いよく	名	干劲、热情
依頼	いらい	名，サ変	拜托、请求；依靠、依赖；委托
以来	いらい	名	那之后、以来；今后
いらいら	いらいら	副，サ変	情绪急躁、心理不安
いらっしゃる	おらっしゃる	自五	（敬语）来；（敬语）去；（敬语）在
入り口	いりぐち	名	入口
要る	いる	自五	需要、必要
居る	いる	自上一	（指人、动物等）有、在、居住在
射る	いる	他上一	射；击中；照射
入る	いる	自五	进入
炒る	いる	他五	炒、煎
衣類	いるい	名	衣类（衣服的总称）
入れる	いれる	他下一	装、放入；让入、让进；容纳；镶嵌；购进、输入；雇用、采用；添、加；承认、容忍；加入；入校、住院；包含；交钱；投票；想、记住；集中；倒（茶、咖啡等）；使起作用；听
色	いろ	名	色彩；肤色；表情；景象、样子；种类；恋爱、女色
色色	いろいろ	名，副，形動	各种各样
色気	いろけ	名	魅力；春心；野心
彩る	いろどる	他五	着色；装饰
岩	いわ	名	岩石
祝う	いわう	他五	庆祝；祝贺、贺礼
言わば	いわば	副	说起来、可以说
所謂	いわゆる	連体	所谓的
因果	いんが	名	因果；不幸
印刷	いんさつ	名，サ変	印刷
印象	いんしょう	名	印象
引退	いんたい	名，サ変	引退
いんちき	いんちき	名，形動	骗人、捣鬼、假货
陰謀	いんぼう	名	阴谋
引用	いんよう	名，サ変	引用
引力	いんりょく	名	引力
上	うえ	名	上面；表面；有关；还、而且；之后；既然……就；（接尾词）对长辈的敬称
植え付ける	うえつける	他下一	种植物；灌输（思想、意识等）
飢える	うえる	自下一	饥饿；渴望
植える	うえる	他下一	种、植；嵌入；打疫苗
魚	うえる	名	鱼
伺う	うかがう	他五	打听；听说；访问；发言、讲话
窺う	うかがう	他五	偷窥；察言观色；瞄准机会；察知
浮かぶ	うかぶ	自五	浮上水面、在空中飘；浮现、显露；想起
浮かべる	うかべる	他下一	浮、泛；露出、现出；想起
受かる	うかる	自五	考上、考中；及格
浮き上がる	うきあがる	自五	飘浮在空中、浮在水面上；现出轮廓；脱离；翻身、发迹
浮き彫り	うきぼり	名	浮雕；突出的表现
浮き世	うきよ	名	（不尽人意的）世上、社会上
浮く	うく	自五	浮、飘、现；结余、剩余；高兴
受け入れる	うけいれる	他下一	接受；采纳；接纳
承る	うけたまわる	他五	谨听；听说；谨受
受け付ける	うけつける	他下一	受理；接受、采纳；对（药品、食物等）吸收
受け取る	うけとる	他五	接、收、领；理解
受け身	うけみ	名	被动、守势；消极；（语法）被动态
受ける	うける	自，他下一	获得；接住、挡住；接受邀请、要求；接受；上课、接受考试；遭到；响应、接受；继承；受欢迎
動かす	うごかす	他五	使活动、开动、移动；变更；使感动、施加影响；使形动；影响；经营
動く	うごく	自五	动、晃动；转动、开动；摇晃；活动；（受到影响而）行动；变更、变动
兎	うさぎ	名	兔
胡散	うさん	形動	蹊跷
牛	うし	名	牛
失う	うしなう	他五	失去、丧失；错过；丧、亡
後ろ	うしろ	名	后面；后背
後ろ向き	うしろ向き	名	背身、背对着；消极
埋もれる	うずもれる	自下一	被埋上；埋没
渦巻き	うずまき	名	漩涡
薄い	うすい	形	薄的；色、味淡；（浓度、密度）低；程度低、缺乏
薄める	うすめる	他下一	弄淡、弄稀
嘘	うそ	名	谎言；错误；不合适、不合时宜
歌う	うたう	他五	唱、唱歌；作诗（歌）；鸟儿鸣唱
疑う	うたがう	他五	猜疑；担心、怀疑；嫌疑
疑わしい	うたがわしい	形	可疑、奇怪
家	うち	名	房屋；自己的家（庭）
内	うち	名	里面、内；内心；自己所在的组织、团体；在一定的范围、区域之内；（时间）以内；出于某种状态之中
打ち上げる	うちあげる	他下一	发射；被浪涛冲上岸；工作结束
打ち合わせる	うちあわせる	他下一	使碰撞、互击；商量
内側	うちがわ	名	内侧；内部的事
宇宙	うちゅう	名	宇宙
打つ	うつ	自他五	打、敲响；敲打；击（球）；击（键盘）；注射；撒；（围棋等）下子；令人感动、打动
うっかり	うっかり	副，サ変	迷糊、心不在焉；疏忽
美しい	うつくしい	形	美好的、优美的；高尚的
移す	うつす	他五	移动；调动工作、转校；转移（注意力）；移交；改变状态；传染
写す，映す	うつす	他五	誊写、抄写；拍照；描写
訴える	うったえる	他下一	控告、诉讼；主张；诉诸于……；感动、打动
鬱陶しい	うっとうしい	形	烦闷；讨厌、不痛快
うっとり	うっとり	副，サ変	出神、入迷
うつ伏せる	うつぶせる	自他一	倒置；俯伏、趴着
俯く	うつむく	自五	俯首、垂头
移る	うつる	自五	迁移、搬动；（地位等）发生变化；变迁；（话题、兴趣发生）变化；传染；熏上、染上
写る，映る	うつる	自五	映、照；被拍摄；照相
器	うつわ	名	器皿；才能、气量
腕	うで	名	手腕、胳膊；本事、技能
うとうと	うとうと	副，サ変	迷迷糊糊、昏昏沉沉
促す	うながす	他五	催促、敦促；促进、劝说
鰻	うなぎ	名	鳗鱼、鳝鱼
頷く	うなずく	自五	首肯、点头
項垂れる	うなだれる	自下一	低头、垂头
唸る	うなる	自五	（猛兽、犬类）吼、啸、叫等；呻吟、哼哼；发出呜呜声；吟、哼、唱；赞叹、叫好；有很多
自惚れる	うぬぼれる	自下一	自负、陶醉
うねる	うねる	自五	蜿蜒起伏
奪う	うばう	他五	抢夺；强烈吸引、迷人
馬	うま	名	马
旨い	うまい	形	美味的；高明、擅长；方便、顺利
旨味	うまみ	名	美味、好味道；巧妙、有益处；利益
埋まる	うまる	自五	埋着；满满；填补、弥补
生まれる	うまれる	自下一	出生、诞生；产生、出现
海	うみ	名	海岸、湖滨
膿	うみ	名	脓
生み出す	うみだす	他五	生、产；产生出、创造出
生む，産む	うむ	他五	生、产；产生、产出
有無	うむ	名	有无
梅	うめ	名	梅花、梅树、梅子
埋める	うめる	他下一	埋入；填满；满满的；填补；（往热水里）兑凉水
恭しい	うやうやしい	形	彬彬有礼、恭敬的
敬う	うやまう	他五	尊敬、尊重
浦	うら	名	海滨、海湾
裏	うら	名	里面；反面、背面；货币的背面；衣服等的里子；鞋底；后面；内幕；幕后
裏切る	うらぎる	他五	不守信条、背叛；辜负、与期待相反
占う	うらなう	他五	占卜
恨む	うらむ	他五	怨恨、抱怨
羨ましい	うらやましい	形	羡慕
麗らか	うららか	形動	和煦、晴朗；快乐
売り切れる	うりきれる	自下一	卖光
売り込む	うりこむ	他五	推销；（自我）推销、争取信任
売り出す	うりだす	他五	开始出售；崭露头角
売る	うる	他五	卖、出售；沽名、扬名；出卖、背叛；找碴、挑起
潤う	うるおう	自五	湿润；受益、受惠
煩い，五月蝿い	うるさい	形	吵闹；讨厌、烦人；纠缠不休；议论纷纷
漆	うるし	名	漆
潤む	うるむ	自五	湿润
麗しい	うるわしい	形	美丽、动人；晴朗；健康
憂い	うれい	名	担心、忧虑
嬉しい	うれしい	形	高兴、快活
売れ行き	うれゆき	名	（商品的）销售情况、销路
うろうろ	うろうろ	副，サ変	徘徊、彷徨；心神不安、不知所措
浮気	うわき	名	见异思迁、对爱情不专一
噂	うわさ	名	闲谈、传言、风言风语
上滑り	うわすべり	名，形動，サ変	表面光滑；肤浅、皮毛
上手	うわて	名	强手；高明
運	うん	名	运气
運営	うんえい	名，他サ	运作、管理
うんざり	うんざり	副，サ変	厌烦、腻
運送	うんそう	名，サ変	运送
運転	うんてん	名，サ変	驾驶；操纵；运转、周转
運動	うんどう	名，サ変	运动
運命	うんめい	名	命运
運輸	うんゆ	名	运输
運用	うんよう	名，他サ	运用
絵	え	名	绘画、画面
永遠	えいえん	名	永远
映画	えいが	名	电影
永久	えいきゅう	名	永久、永远
影響	えいきょう	名，サ変	影响
営業	えいぎょう	名，サ変	营业
英語	えいご	名	英语
栄光	えいこう	名	光荣
衛生	えいせい	名	卫生
衛星	えいせい	名	卫星
映像	えいぞう	名	影像、映像；印象
英雄	えいゆう	名	英雄
栄誉	えいよ	名	荣誉
栄養	えいよう	名	营养
営利	えいり	名	盈利、谋利
笑顔	えがお	名	笑脸、笑容
描く	えがく	他五	画、描绘；造型；表现；想象
駅	えき	名	车站
液体	えきたい	名	液体
笑窪	えくぼ	名	酒窝、笑窝
抉る	えぐる	他五	挖、剜；刺痛；追究、深挖
えこ	えこ	名	偏袒、不公平
餌	えさ	名	饲料；诱饵、食物（俗）
枝	えだ	名	枝
得体	えたい	名	本来面目
閲覧	えつらん	名，サ変	阅览
江戸	えど	名	江户（东京的旧称）
笑み	えみ	名	笑脸；（果实成熟后的）裂口
獲物	えもの	名	猎获物；战利品
偉い	えらい	形	杰出、卓越；地位（身份）高；（出乎意料地）严重、厉害
選ぶ	えらぶ	他五	挑选；看重；选拔；选举
襟	えり	名	衣襟
選り好み	えりごのみ	名	挑剔
得る	える	他下一	（通过努力、手段等）得到；能、可能
円	えん	名	圆形；日元
縁	えん	名	缘分、血缘、姻缘、关系
延延	えんえん	形動	没完没了
円滑	えんかつ	形動	圆滑；顺利
縁起	えんぎ	名	事物、寺庙等的由来；前兆
演技	えんぎ	名	演技
婉曲	えんきょく	形動	委婉、婉转
演劇	えんげき	名	演剧、戏剧
援護	えんご	名，サ変	支援、援救
演習	えんしゅう	名，サ変	演练；大学的专题讨论；军队的演习
演出	えんしゅつ	名，サ変	（戏剧、电视剧等的）导演
援助	えんじょ	名，サ変	支援、援救
炎症	えんしょう	名	炎症
演じる	えんじる	他上一	上演、演出；做出（坏事等）、扮演
沿線	えんせん	名	沿线、沿途
演説	えんぜつ	名	演说
演奏	えんそう	名，他サ	演奏
縁談	えんだん	名	亲事、说媒
延長	えんちょう	名，サ変	延长；延长时间；全长；延长线
鉛筆	えんぴつ	名	铅笔
円満	えんまん	名，形動	完满、完美；圆满
遠慮	えんりょ	名，自サ	远虑；礼让、谦虚；客气；谢绝
老い	おい	名	老年、衰老
追いかける	おいかける	他下一	追赶；迫于；紧接
追い越す	おいこす	他五	赶超；超过
追い込む	おいこむ	他五	赶进；比如困境
美味しい	おいしい	形	味美、好吃；有魅力
追い出す	おいだす	他五	赶出某地；逐出某组织、集团等
生い立ち	おいたち	名	成长；经历
追い立てる	おいたてる	他下一	驱赶；驱逐；追赶
追い詰める	おいつめる	他下一	追猎物；穷追
追い払う	おいはらう	他五	驱赶；轰走
追う	おう	他五	追赶犯人、猎物等；驱赶；轰走；驱逐、清除；追求；按照顺序、随着时间
負う	おう	他五	背负；接受、担负责任；多亏、借助于；受伤
応援	おうえん	名，サ変	支持；声源、从旁助威
応急	おうきゅう	名	应急
往生	おうじょう	名，サ変	（佛教）往生、极乐净土；死；难于应付、一筹莫展
応じる	おうじる	自上一	回答；应允、满足；适应、按照
応接	おうせつ	名，サ変	接待
応対	おうたい	名，サ変	接待、应酬
横断	おうだん	名，他サ	横穿；横断、横越
横着	おうちゃく	名，形動，サ変	脸皮厚、懒惰
応答	おうとう	名，サ変	应答、应对
往復	おうふく	名，サ変	往返；书信往来；交际
欧米	おうべい	名	欧美
応募	おうぼ	名，サ変	应聘、应征
横暴	おうぼう	名，形動	蛮横
応用	おうよう	名，サ変	应用
往来	おうらい	名	往来；道路；交际
終える	おえる	他下一	完成、结束
多い	おおい	形	数量多；次数多、程度深
覆う	おおう	他五	蒙上、盖上；充满；包藏、掩饰；笼罩
大方	おおかた	名，副	大体、大致；大约是
大型	おおがた	名	大型
大きい	おおきい	形	大的、个子高的；数目大；音量大；年长的；成长、长大；（规模等）大；夸大、夸张；显得了不起、傲慢；胸怀开阔；重大
大きな	おおきな	連体	大的、个子高的；数目大；音量大；年长的；成长、长大；（规模等）大；夸大、夸张；显得了不起、傲慢；胸怀开阔；重大
大げさ	おおげさ	形動	夸大、小题大做、铺张
大ざっぱ	おおざっぱ	形動	粗略、大致；粗糙、草率
大勢	おおぜい	名	人数多
大まか	おおまか	形動	大大咧咧、粗略；大致
大晦日	おおみそか	名	除夕、大年三十
概ね	おおむね	副	基本上、大约
大家	おおや	名	房东、房主
公	おおやけ	名	公家、各级政府、集体组织；公共；公开
丘	おか	名	丘陵、山岗、小山
可笑しい	おかしい	形	可笑的、滑稽的；不正常的；可疑的
侵す	おかす	他五	侵犯（国土、领域等）
犯す	おかす	他五	犯法、违反道德；强奸、施暴
冒す	おかす	他五	冒着危险、不顾困难；加害、带来伤害；亵渎
拝む	おがむ	他五	礼拜、祈愿；恳求、央求；瞻仰、见识
補う	おぎなう	他五	弥补
起きる	おきる	自上一	起床；不睡；离开病床；起身、站起来；发生、产生
奥	おく	名	里头、深处；后面；里屋、内宅、上房；胸中
億	おく	名	亿
置く	おく	自他五	摆、置；放置；放下、留下、丢下；购入以备出售；设置；任命、雇用；留在家住；积存、委托；搁笔；保存；隔、间隔；处于某种状态；预先做好某种准备动作；继续保持某种状态
憶測	おくそく	名，サ変	臆测
奥の手	おくのて	名	绝招、花招；秘诀
臆病	おくびょう	名，形動	胆怯
臆面	おくめん	名	腼腆、害羞
奥行き	おくゆき	名	进深、纵深；（学文）等的深度
送る	おくる	他五	邮寄；派遣；送人、送行；吊唁、送别（死者）；渡过；依此传递、移动；送；标上送假名
贈る	おくる	他五	赠送；授予（称号等）；报以、致以
遅れる	おくれる	自下一	迟到、赶不上；比预定晚；钟、表慢了
起こす，興す	おこす	他五	扶起；叫醒；翻起、弄起；开始；发动；生病；（思想、感情等）引起、惹起；发热、发电
厳か	おごそか	形動	庄严、肃穆
怠る	おこたる	自他五	懒惰、松懈、大意
行う	おこなう	他五	做、办；实施、举行
起る	おこる	自五	发生、产生；起因；兴起、起源；发热、发电；电源
興る	おこる	自五	繁荣、兴起
怒る	おこる	自五	生气；训斥、呵斥
奢る	おごる	自五	奢侈、铺张；请客、做东
押さえる	おさえる	他下一	压、按、捂；堵；抓住
抑える	おさえる	他下一	抑制；压倒、凌驾；抑制感情；降低程度
幼い	おさない	形	幼小的；幼稚的
治まる	おさまる	自五	变得安定；止痛；心情平静
収まる	おさまる	自五	收纳、整齐地收好；解决、平息
納まる	おさまる	自五	缴纳；稳坐……的交椅；心满意足
修まる	おさまる	自五	端正
治める	おさめる	他下一	平定；统治、治理
収める	おさめる	他下一	收录；获得
納める	おさめる	他下一	接受；缴纳；结束
修める	おさめる	他下一	掌握学问；修、修养
惜しい	おしい	形	珍惜、可贵；可惜、委屈；遗憾
お爺さん	おじいさん	名	爷爷、祖父、外祖父
教える	おしえる	他下一	教、传授；告诉、指点
お辞儀	おじぎ	名，サ変	敬礼、行礼、鞠躬
押し切る	おしきる	他五	（不顾反对）坚持到底
押しつける	おしつける	他下一	压上、按上；强加于人
惜しむ	おしむ	他五	珍惜；认为可惜、吝啬；惋惜
おしゃべり	おしゃべり	形動，名，サ変	闲聊、聊天；多嘴多舌、健谈（的人）；议论、传言、风言风语
お洒落	おしゃれ	名，形動	好打扮、爱俏（的人）
押す，推す，捺す	おす	他五	推、挤；压、碰；盖章；强行；压倒；顶住、不顾
雄	おす	名	雄性
お世辞	おせじ	名	恭维（话）、奉承（话）
汚染	おせん	名	污染
遅い	おそい	形	速度慢、迟缓；夜深；时间湾、迟
襲う	おそう	他五	袭击、侵袭；继承
恐れ入る	おそれいる	自五	不好意思；折服、佩服
恐れる	おそれる	自下一	害怕、畏惧；担心；敬畏
恐ろしい	おそろしい	形	可怕的；惊人的、非常的
教わる	おそわる	他五	受教
煽てる	おだてる	他下一	挑唆、煽动；讨好、取悦
穏やか	おだやか	形動	平静、平稳；温和、安详
陥る	おちいる	自五	落入、掉进；陷入（不良）状态；中计
落ち込む	おちこむ	自五	掉进、落入；塌陷、下陷；消沉、处于不好的状态
落ち着く	おちつく	自五	镇静、平心静气；稳定、安定；做得稳；有头绪；有头绪、有结果；（颜色、衣服等）淡雅
落ち度	おちど	名	过失
落ち目	おちめ	名	败运
お茶	おちゃ	名	茶
落ちる	おちる	自上一	落下；崩溃、陷没；下、降；西沉、下山；脱落、褪色；漏掉；钱被用掉；落榜、落选；程度低；处于某种状态；失陷、为人所有；兑现票据；堕落；归根结底；招供
億劫	おっくう	形動	嫌麻烦、懒得做
おっきゃる	おっきゃる	他五	说、称呼（敬语）
夫	おっと	名	丈夫
音	おと	名	（物体发出的声响）
弟	おとうと	名	弟弟
おどおど	おどおど	副，サ変	心虚、胆怯
脅かす	おどかす	他五	威胁、吓唬
男	おとこ	名	男性、男子汉、大丈夫气质
陥れる	おとしいれる	他下一	使……陷入；陷害
落とす	おとす	他五	投下、扔下；弄掉、除掉；丢失、遗漏；减弱、降低；使陷入不好的状态；花钱；使落第；败；处理
脅す	おどす	他五	威胁
訪れる	おとずれる	自下一	拜访；到来
一昨日	おととい	名	前天
一昨年	おととし	名	前年
大人	おとな	名	成人
大人しい	おとなしい	形	老实、温顺；（颜色等）素气
劣る	おとる	自五	劣、次
踊る	おどる	自五	跳舞；被操纵
躍る	おどる	自五	跳跃；激动
衰える	おとろえる	自下一	衰退
驚く	おどろく	自五	惊讶、惊叹；吃惊、惊慌
同じ	おなじ	連体，形動	（性质、种类等）相同；一样的；相等；（以“同じ……なら”的形式）反正
鬼	おに	名	鬼怪、穷凶极恶的人
斧	おの	名	斧子
各々	おのおの	名，副	各自、分别
自ずから	おのずから	副	自然而热地
お婆さん	おばあさん	名	奶奶、姥姥、老奶奶
お化け	おばけ	名	妖怪、来历不明的人
十八番	おはこ	名	拿手好戏、得以本领
帯	おび	名	衣带；（绕在杂志或书皮外做广告用的）腰封
夥しい	おびただしい	形	很多的、非常多的；特别
帯びる	おびる	他上一	佩带、带；委任；包含、带有
覚える	おぼえる	他下一	记忆；学习、掌握；感觉、感到
覚束ない	おぼつかない	形	靠不住的、没有希望的；没有把握的、含糊不清
溺れる	おぼれる	自下一	溺水；沉溺于、专心于
主	おも	形動	主要的
重い	おもい	形	重的；沉重的；重要的；（情况、程度等）重大的
思い切り	おもいきり	名，副	尽情；果断
思い付き	おもいつき	名	想法；偶然的想法
思い詰める	おもいつめる	自下一	钻牛角尖、左思右想；过度地思虑
思い出	おもいで	名	追忆、怀念
思いやる	おもいやる	他五	同情；令人担心
思う	おもう	他五	考虑；怀疑；推测；想象；感觉；期望；牵挂；爱慕；想出
面白い	おもしろい	形	有趣的；可笑的；用否定形式表示情况不妙
玩具	おもちゃ	名	玩具；玩物
表	おもて	名	正面；家的正面；户外；棒球比赛的前半场；表面
趣	おもむき	名	趣味、情趣；内容；风格
赴く	おもむく	自五	奔赴、前往；趋向、倾向
重んじる	おもんじる	他上一	重视、注重；敬重
親	おや	名	父母
親子	おやこ	名	父母和子女；主从关系
泳ぐ	およぐ	自五	游泳；踉跄、栽倒；穿过；处世
凡そ	およそ	名，副	大体上；大约；总的说来；完全、全然
及び	および	接	以及
及ぶ	およぶ	自五	达到；发展成、临到；匹敌、比得上；（用否定的形式表示）不需要、不必
及ぼす	およぼす	他五	影响到、使遭到
折	おり	名	时机、机会、时候
折り返す	おりかえす	他五	折起、翻卷；返回、折回
織り込む	おりこむ	他五	织入；穿插、编进去
降りる	おりる	自上一	（从交通工具中）下来；退位；半道退出；降霜等
下りる	おりる	自上一	降下；批准、发下来；落锁
折る	おる	他五	折；折断；弯曲
折れる	おれる	自下一	折叠；折断；拐弯；让步
おろか	おろか	名，形動	不用说、岂止
愚か	おろか	形動	愚蠢、笨
降ろす	おろす	他五	让人下来；卸下；降旗；退位
下ろす	おろす	他五	放下、取下；风从高处刮下；落（发）；上锁；切鱼肉；擦丝；使用新产品；取出；打胎
卸す	おろす	他五	批发
疎か	おろそか	形動	粗心大意、马虎
終わる	おわる	自他五	完
恩	おん	名	恩情
音楽	おんがく	名	音乐
穏健	おんけん	名，形動	稳健
温厚	おんこう	名，形動	温厚、敦厚
音声	おんせい	名	声音
温泉	おんせん	名	温泉
温暖	おんだん	名，形動	温暖
音痴	おんち	名	五音不全的人、音盲；某方面感觉迟钝的人
温度	おんど	名	温度
女	おんな	名	女性；情妇；女佣人
温和	おんわ	形動	气候温和；性格温和
貝	かい	名	贝类
甲斐	かい	名	效果、价值
害	がい	名	害、害处
外貨	がいか	名	外国的货币；外国产的商品
開会	かいかい	名，サ変	开会
海外	かいがい	名	海外、外国
改革	かいかく	名，サ変	改革
貝殻	かいがら	名	贝壳
快感	かいかん	名	快感、愉快
海岸	かいがん	名	海岸
会議	かいぎ	名	会议
階級	かいきゅう	名	阶级
海峡	かいきょう	名	海峡
開業	かいぎょう	名，サ変	开业
会計	かいけい	名	会计；付款
解決	かいけつ	名，サ変	解决
会見	かいけん	名，サ変	会见
外見	がいけん	名	外表、外观
回顧	かいこ	名，サ変	回顾
解雇	かいこ	名，サ変	解雇
介護	かいご	名，サ変	照顾病人
会合	かいごう	名，サ変	集合、集会、聚集
外交	がいこう	名	外交；推销
外向	がいこう	名	外向
外国	がいこく	名	外国
開催	かいさい	名，サ変	举行
改札	かいさつ	名，サ変	检票
解散	かいさん	名，サ変	解散；组织解体；国会解散
開始	かいし	名，サ変	开始
会社	かいしゃ	名	公司
解釈	かいしゃく	名，サ変	解释
回収	かいしゅう	名，サ変	回收；取回
外出	がいしゅつ	名，サ変	外出
解消	かいしょう	名，サ変	接触；消除；组织等的解散
会場	かいじょう	名	会场
外食	がいしょく	名，サ変	在外吃饭
外人	がいじん	名	外人、外国人
回数	かいすう	名	次数
快晴	かいせい	名	天气晴好
改正	かいせい	名，サ変	改正
解説	かいせつ	名，サ変	解说
開設	かいせつ	名，サ変	开设
改善	かいぜん	名，サ変	改善
階層	かいそう	名	阶层
改造	かいぞう	名，サ変	改造；组织等的改变
解体	かいたい	名，サ変	瓦解、分解；组织解散
開拓	かいたく	名，サ変	开发土地、资源等；开拓
階段	かいだん	名	楼梯
会談	かいだん	名，サ変	会谈
改築	かいちく	名，サ変	改建、重建
懐中	かいちゅう	名	怀里、怀中；钱包
快調	かいちょう	名，形動	情况良好；状况；顺利
開通	かいつう	名，サ変	开通
改定	かいてい	名，サ変	重新修订
外敵	がいてき	名	外敌
回転	かいてん	名，サ変	转；脑子转得（快等）；资金周转
解答	かいとう	名，サ変	解答
回答	かいとう	名，サ変	回答
該当	がいとう	名，サ変	符合、适合、相当
介入	かいにゅう	名，サ変	介入
解任	かいにん	名，サ変	解职、免职
概念	がいねん	名	概念
開発	かいはつ	名，サ変	开发
回避	かいひ	名，サ変	回避
外部	がいぶ	名	外侧；外界
回復	かいふく	名，サ変	恢复；康复、复原
開放	かいほう	名，サ変	打开；出入自由；开放
快方	かいほう	名	病情转好
解放	かいほう	名，サ変	解放
解剖	かいぼう	名，サ変	解剖；分析
開幕	かいまく	名，サ変	开幕；事物的开始
外面	がいめん	名	外观；表面
買い物	かいもの	名	买东西、买的东西；买得合算的东西
海洋	かいよう	名	海洋
外来	がいらい	名	外来
改良	かいりょう	名，サ変	改良
回路	かいろ	名	线路、电路
会話	かいわ	名，サ変	会话
買う	かう	他五	买；招、招致、惹起；主动承担；高度评价、赏识
飼う	かう	他五	饲养
返す	かえす	他五	归还；汇报，回敬，报酬；回礼
かえって	かえって	副	反而、反倒
顧みる，省みる	かえりみる	他上一	回头看；回顾；反省；牵挂
蛙	かえる	名	青蛙
返る	かえる	自五	复原；复归
帰る	かえる	自五	回来（去）；归去；（否定形式）死
代える	かえる	他下一	代替
換える	かえる	他下一	交换
替える	かえる	他下一	替换
変える	かえる	他下一	改变；移到别的地方
顔	かお	名	脸、表情
顔なじみ	かおなじみ	名	面熟、熟人
香る，薫る	かおる	自五	飘香
抱える	かかえる	他下一	用手抱；有麻烦事；雇
科学	かがく	名	科学
化学	かがく	名	化学
掲げる	かかげる	他下一	高举；登载；提出方针等
鏡	かがみ	名	镜子
鑑	かがみ	名	榜样
屈む	かがむ	自五	弯腰；蹲下
輝く	かがやく	自五	闪烁；灿烂
掛かる	かかる	自五	悬、垂、吊；放在火上；降临、落到（身上）；锁着；放在上面；挂住、陷入；设置；靠着；发动；攻击；到达某处；接受；委任、给人以；挂（来电话）；被会议等讨论、受理；留在心里；接受照料、看视等；花费的时间；拥有保险之类的契约；上缴税金等；着手；一开始就认定
拘わらず	かかわらず	連	尽管；不问、不管
関る	かかわる	自五	有关；拘泥
牡蠣	かき	名	牡蛎
柿	かき	名	柿子
鍵	かぎ	名	钥匙；线索、关键
掻き立てる	かきたてる	他下一	用力搅拌；挑起、煽动
掻き回す	かきまわす	他五	混合、搅拌；翻弄；扰乱
限る	かぎる	他五	限制、限于；最好；（否定的形式）不一定、未必
欠く	かく	他五	打坏；缺乏
書く	かく	他五	写、画；写文章
掻く	かく	他五	抓、挠；搅拌；削去；推开、分开
嗅ぐ	かぐ	他五	闻、嗅
家具	かぐ	名	家具
架空	かくう	名	空中架设；空想、虚构
格言	かくげん	名	格言
覚悟	かくご	名，サ変	有心理准备；决心；死心
格差	かくさ	名	差距、差别
拡散	かくさん	名，サ変	液体、气体等的弥散；扩散
学識	がくしき	名	学识
確実	かくじつ	形動	确实；可以信赖；坚实、可靠
学者	がくしゃ	名	学者
拡充	かくじゅう	名，サ変	扩充
学習	がくしゅう	名，サ変	学习
学術	がくじゅつ	名	学术；学问
確信	かくしん	名，サ変	确信、坚信
革新	かくしん	名，サ変	革新
隠す	かくす	他五	掩盖；隐藏、隐瞒
学生	がくせい	名	学生
拡大	かくだい	名，サ変	扩大
各地	かくち	名	各地
拡張	かくちょう	名，サ変	扩张
格調	かくちょう	名	格调
確定	かくてい	名，サ変	确定
角度	かくど	名	角度；观点
格闘	かくとう	名，サ変	格斗
獲得	かくとく	名，サ変	获得
確認	かくにん	名，サ変	确认
学年	がくねん	名	学年
学費	がくひ	名	学费
格別	かくべつ	副，形動	格外；特别
確保	かくほ	名，サ変	确保
革命	かくめい	名	革命
学問	がくもん	名	学问
確率	かくりつ	名	概率
学力	がくりょく	名	学力
学歴	がくれき	名	学历
隠れる	かくれる	自下一	隐藏；躲藏；隐遁；作为借口
影	かげ	名	光；月光；倒影、影像；踪影、行踪；暗面
家計	かけい	名	家庭经济状况
過激	かげき	形動	过激
欠ける	かける	自下一	缺损；月蚀、日食；欠缺
掛ける	かける	他下一	垂下、悬、挂；放置火上；覆盖；洒；锁上、扣上；轻轻握住、搭着等；钩、钓；捆（箱子等）；设置；靠着；开动、使运转；坐；佩戴；设计使陷入圈套；影响到；打招呼；作用到；讨论；送入；花费；加入保险；征收；乘法
賭ける	かける	他下一	赌
駆ける	かける	自下一	跑、快跑；骑马跑
加減	かげん	名，サ変	加法和减法；调节；事物的状态；健康状态；稍微
過去	かこ	名	过去；人的经历
加工	かこう	名，サ変	加工
託ける	かこつける	自他下一	借口、托词
囲む	かこむ	他五	围绕、环绕；包围
傘	かさ	名	伞
火災	かさい	名	火灾
重なる	かさなる	自五	重叠；累积
重ねる	かさねる	他下一	摞起、使重叠；反复；累积
風向き	かざむき	名	风向；形势；心情
飾る	かざる	他五	装饰；陈列；登载；修饰文章
菓子	かし	名	点心、糖果
舵	かじ	名	舵
家事	かじ	名	家务事
火事	かじ	名	火灾
傾げる	かしげる	他下一	歪斜、倾斜
賢い	かしこい	形	聪明、伶俐；周到
畏まる	かしこまる	自五	恭敬；正坐；（谦）知道了、遵命
過失	かしつ	名	过失
貸家	かしや	名	出租的房子
歌手	かしゅ	名	歌手
過剰	かじょう	名，形動	过剩、过多
頭	かしら	名	头、脑袋；首领
貸す	かす	他五	借款、贷款；出租；帮助、出力
数	かず	名	数目、数
微か	かすか	形動	隐隐约约、微弱
霞む	かすむ	自五	笼罩着云霭、薄雾；模糊；不显眼
掠める	かすめる	他下一	掠夺、掠取；掠过、擦过；骗过、瞒过
風	かぜ	名	风；架子、派头
風邪	かぜ	名	感冒
化石	かせき	名	化石
稼ぐ	かせぐ	自他五	做工赚钱；努力争取
仮説	かせつ	名	假说
仮設	かせつ	名，サ変	假定；临时设定
架設	かせつ	名，サ変	安装、架设
下線	かせん	名	下划线
河川	かせん	名	河流
数える	かぞえる	他下一	数数；列举
家族	かぞく	名	家族
肩	かた	名	肩膀；衣服的肩部；器物的上方
形	かた	名	形状
方	かた	名，造語	方位；（敬称）人；解决
固い	かたい	形	坚硬的；紧的；坚定的；严重的；确实的；顽固的
硬い	かたい	形	坚硬的；僵、硬；生涩的、生硬的；表情僵硬
堅い	かたい	形	坚实的；可以信赖的；严肃的
課題	かだい	名	课题、任务；作业
かたがた	かたがた	接続	顺便、同时做别的
敵，仇	かたき	名	竞争对手；仇人
形	かたち	名	形状；形式、表面
片付ける	かたづける	他下一	收拾；解决；嫁出去；除去妨碍者
刀	かたな	名	刀
固まる	かたまる	自五	凝固；集中到一处；确实、可靠
傾く	かたむく	自五	倾斜；日、月西沉；衰落；带有某种倾向
固める	かためる	他下一	使坚固；坚守；坚定；安定、稳定；归拢到一起
偏る，片寄る	かたよる	自五	偏重、失去平衡；偏向；偏颇
語る	かたる	他五	谈、叙述
傍ら	かたわら	名	旁边；同时
価値	かち	名	价值
家畜	かちく	名	家畜
勝つ	かつ	自五	得胜；胜过、超过
且つ	かつ	接続	而且、并且；同时
学科	がっか	名	学科
がっかり	がっかり	副，サ変	失望的样子；非常疲劳的样子
活気	かっき	名	活力
楽器	がっき	名	乐器
学期	がっき	名	学期
画期的	かっきてき	形動	划时代的
担ぐ	かつぐ	他五	担负；推举；骗人、捉弄人；迷信
括弧	かっこ	名	括号
格好	かっこう	名	外形、姿态、装束；正好、合适
学校	がっこう	名	学校
活字	かつじ	名	铅字、活字
合唱	がっしょう	名	合唱
合戦	かっせん	名，サ変	对打、交战
かつて	かつて	副	曾经、以前
勝手	かって	名，形動	厨房；生活状况；情形；样子、状况；任性、随便
活動	かつどう	名	活动
活発	かっぱつ	形動	活跃、活泼
合併	がっぺい	名，サ変	合并
活躍	かつやく	名，サ変	活跃
活用	かつよう	名，サ変	活用
糧	かて	名	干粮、粮食
過程	かてい	名	过程、经过
家庭	かてい	名	家庭
仮定	かてい	名	假定、架设
家内	かない	名	家中；（谦）内人
叶う	かなう	自五	（愿望）实现
適う	かなう	自五	合乎；比得上
悲しい	かなしい	形	悲伤的、可悲的
悲しむ	かなしむ	他五	悲伤、悲痛
要	かなめ	名	扇轴；要点、要害
必ず	かならず	副	一定
必ずしも	かならずしも	副	（下接否定）未必、不一定
かなり	かなり	副，形動	很、颇、相当
金	かね	名	金属；金钱
鐘	かね	名	钟
兼ねる	かねる	他下一	兼有；不能、难以
可能	かのう	名	可能
彼女	かのじょ	名，代	她；女朋友、恋人（女）
庇う	かばう	他五	庇护
鞄	かばん	名	包
黴	かび	名	霉（总称）；迂腐陈旧
株	かぶ	名	树墩、残株；草木的根；股票；职业上的特权、特殊身份
被せる	かぶせる	他下一	盖上、罩上；洒、浇；推诿
被る	かぶる	他五	盖、戴、蒙；浇；蒙受
花粉	かふん	名	花粉
壁	かべ	名	墙；障碍、障碍物
貨幣	かへい	名	货币
過保護	かほご	名，形動	溺爱
釜	かま	名	锅
構う	かまう	自他五	介意；干涉；招待；照顾；戏弄
構える	かまえる	他下一	整修、修筑一新；摆出姿势；采取某种态度；托辞、装作
鎌倉	かまくら	名	镰仓
がましい	がましい	接尾	接近于、类似
我慢	がまん	名，サ変	忍耐
上	かみ	名	开头；上游；天皇、将军
神	かみ	名	神
紙	かみ	名	纸；划拳时的纸（中国为布）
髪	かみ	名	头发、发型
神様	かみさま	名	神；具有非凡能力的人
過密	かみつ	名，形動	过密、高度集中
噛み付く	かみつく	他五	咬住；极力争辩
雷	かみなり	名	雷
噛む	かむ	他五	咬、嚼；齿轮咬合；简易的说；（水）猛烈冲击；有关系的
亀	かめ	名	龟
仮面	かめん	名	假面、面具；伪装
科目	かもく	名	项目、条目；科目
貨物	かもつ	名	货物
粥	かゆ	名	粥
痒い	かゆい	形	痒
通う	かよう	自五	上班、走读；交通工具往来；通往；心意相通；相似、相通
空	から	名	空的
殻	から	名	皮儿、壳儿
柄	がら	名	样子；身材；性质、状态；立场
辛い	からい	形	辣的；咸的；严格的；严酷的
からかう	からかう	他五	嘲笑、戏弄
烏，鴉	からす	名	乌鸦
体	からだ	名	身体；身体状况
空手	からて	名	空手、赤手空拳；空手道
絡まる	からまる	自五	缠绕；有密切关联
絡む	からむ	自五	缠绕；密切联系；纠缠
仮に	かりに	副	临时；假定
借りる	かりる	他上一	借钱、东西等；借助
刈る	かる	他五	割、剪（发）
駆る	かる	他五	驾驶、赶；驱使
軽い	かるい	形	轻的；轻快的；轻微的；轻松的；清淡、少量；容易的；轻率的
彼	かれ	名，代	他；情人（丈夫）
枯れる	かれる	自下一	枯萎；技艺等造诣精深、成熟
過労	かろう	名	劳累过度
辛うじて	かろうじて	副	好不容易、勉强
川，河	かわ	名	河、河流
皮　革	かわ	名	皮、表皮、皮革
側	がわ	名	一侧、一方面
可愛い	かわいい	形	可爱的；讨人喜欢的；小巧的
可哀相	かわいそう	形動	可怜的
渇く	かわく	自五	渴
乾く	かわく	自五	干、干燥
交わす	かわす	他五	交换；互相
瓦	かわら	名	瓦
代わる	かわる	自五	代替、取代
変わる	かわる	自五	变化；变更、转移；区别；特殊
缶	かん	名	（金属）筒、罐、罐头
癌	がん	名	癌
感化	かんか	名，サ変	感化
考える	かんがえる	他下一	思考；深思熟虑；考虑；反省；精神准备、早做准备；决心；预见；想象；设法
間隔	かんかく	名	间隔
感覚	かんかく	名	感觉
観客	かんきゃく	名	观众
環境	かんきょう	名	环境
玩具	がんぐ	名	玩具；玩物
関係	かんけい	名	关系、有关；性关系
歓迎	かんげい	名，サ変	欢迎
感激	かんげき	名，サ変	感激
簡潔	かんけつ	名，形動	间接
還元	かんげん	名，サ変	（化学）还原；还原、返还
漢語	かんご	名	（日语中的）汉语词汇
看護	かんご	名，サ変	看护
頑固	がんこ	名，形動	顽固
観光	かんこう	名，サ変	观光
刊行	かんこう	名，サ変	出版、发行
関西	かんさい	名	关西
観察	かんさつ	名，サ変	观察
監視	かんし	名，サ変	监视
感じ	かんじ	名	感觉、知觉；心情、情感；印象；意境
漢字	かんじ	名	汉字
幹事	かんじ	名	干事；主持人、管事人
元日	がんじつ	名	元旦
感謝	かんしゃ	名，サ変	感谢
慣習	かんしゅう	名	习惯
観衆	かんしゅう	名	观众
願書	がんしょ	名	申请书、志愿书
鑑賞	かんしょう	名，サ変	鉴赏
干渉	かんしょう	名，サ変	干预；干涉；（物理上的）干扰
感傷	かんしょう	名	伤感
感情	かんじょう	名	感情
勘定	かんじょう	名，サ変	计算；付账、结帐；考虑、估计
感触	かんしょく	名	感觉、触感、手感；心中所感
感じる	かんじる	自他上一	感觉；感动；感触
関心	かんしん	名，サ変	关心
感心	かんしん	名，形動，サ変	佩服；赞赏
肝心	かんじん	名，形動	首要、要紧
関する	かんする	サ変	关于
完成	かんせい	名，サ変	完成
歓声	かんせい	名	欢声
岩石	がんせき	名	岩石
間接	かんせつ	名	间接
関節	かんせつ	名	关节
感染	かんせん	名，サ変	感染
幹線	かんせん	名	干线、主线
完全	かんぜん	名，形動	完全
乾燥	かんそう	名，サ変	干燥
感想	かんそう	名	感想
観測	かんそく	名，サ変	观察、测定；观测、推测
簡単	かんたん	名，形動	简单；简短
元旦	がんたん	名	元旦
勘違い	かんちがい	名，サ変	误解
官庁	かんちょう	名	政府机关
缶詰	かんづめ	名	罐头；（被）关在……里（出不来）
観点	かんてん	名	观点
感電	かんでん	名，サ変	触电
関東	かんとう	名	关东
感動	かんどう	名，サ変	感动
監督	かんとく	名，サ変	监督、监视；导演、教练；监工
堪忍	かんにん	名，サ変	容忍；宽恕
観念	かんねん	名，サ変	观念；意识；断念、不抱希望
元年	がんねん	名	元年
官能	かんのう	名	器官的机能；官能、肉感、性感
乾杯	かんぱい	名，サ変	干杯
芳しい	かんばしい	形	芳香；评价好
頑張る	がんばる	自五	努力、全力以赴；主张、固守不动
看板	かんばん	名	招牌、广告牌；信用；幌子；令人瞩目的、招牌类的（人物）；关门、下班
完備	かんび	名，サ変	完备
看病	かんびょう	名，サ変	看护、护理
幹部	かんぶ	名	干部
簡便	かんべん	名，形動	简单、简便
勘弁	かんべん	名，サ変	宽恕；容忍
願望	がんぼう	名，サ変	愿望
冠	かんむり	名	冠、冠冕；（汉字）字头
感銘	かんめい	名，サ変	感动、铭记
喚問	かんもん	名，サ変	传唤、传讯
勧誘	かんゆう	名，サ変	劝诱
慣用	かんよう	名，サ変	惯用
元来	がんらい	副	原来
管理	かんり	名，サ変	管理
簡略	かんりゃく	名，形動	简略
完了	かんりょう	名，サ変	完成、终了
官僚	かんりょう	名	官僚
慣例	かんれい	名	惯例、习惯
還暦	かんれき	名	花甲、六十岁
関連	かんれん	名，サ変	关联
緩和	かんわ	名，サ変	缓和
木	き	名	树、木材
気	き	名	空气；起风；风味、味道；意志；心情；意识；“……する気”的形式表示“准备做”；样子、势头
気合	きあい	名	全神贯注；性情；呼吸
黄色	きいろ	名	黄色
議員	ぎいん	名	议员
機運	きうん	名	时机
気運	きうん	名	趋势、形势
消える	きえる	自下一	火熄灭、火消失等；消失；雪融化；感情、记忆等消失
記憶	きおく	名，サ変	记忆
気温	きおん	名	气温
機会	きかい	名	机会
機械	きかい	名	机械
議会	ぎかい	名	议会
着替え	きがえ	名，サ変	换衣服、换的衣服
規格	きかく	名	规格、格式
企画	きかく	名	计划、规划
利かせる	きかせる	他下一	生效、有效；使发挥作用
聞かせる	きかせる	他下一	使听；讲话、唱歌等中听
気兼ね	きがね	名，サ変	多心、拘束、顾虑
機関	きかん	名	机关
期間	きかん	名	期间
器官	きかん	名	器官
気管	きかん	名	气管
危機	きき	名	危机
聞き苦しい	ききぐるしい	形	（因有杂音等）听不清楚；难听的、不好听的
聞きつける	ききつける	他下一	听到；听惯
効き目	ききめ	名	效用、效力
企業	きぎょう	名	企业
戯曲	ぎきょく	名	戏曲
聞き分ける	ききわける	他下一	听辨出来；听话、懂事
飢饉	ききん	名	饥馑、饥荒
基金	ききん	名	基金；基金会
利く	きく	自五	有效；可能
効く	きく	自五	有效
聞く，聴く	きく	他五	听；听说；听从；遂愿；问、询问；闻、品
喜劇	きげき	名	喜剧
危険	きけん	名，形動	危险
棄権	きけん	名，サ変	弃权
紀元	きげん	名	纪元
起源	きげん	名	起源
期限	きげん	名	期限
機嫌	きげん	名	安泰；心情、情绪
気候	きこう	名	气候、气象
機構	きこう	名	机构
記号	きごう	名	记号
技巧	ぎこう	名	技巧
聞こえる	きこえる	自下一	听得见；听起来似乎是……；有名；理解、同意
刻む	きざむ	他五	切碎肉、蔬菜等；雕刻；钟表计时；铭记
兆し	きざし	名	兆头、预兆
岸	きし	名	岸
生地	きじ	名	布料、衣料的质地；未涂釉的陶瓷胚、素胎；本来的面目
記事	きじ	名	（报纸、杂志）上的报道、消息
技師	ぎし	名	技师、工程师
義歯	ぎし	名	假牙、镶的牙齿
儀式	ぎしき	名	仪式
気質	きしつ	名	气质、风度
期日	きじつ	名	日期、期限
記者	きしゃ	名	记者
汽車	きしゃ	名	火车
記述	きじゅつ	名，サ変	记述
技術	ぎじゅつ	名	记述
基準	きじゅん	名	基准
気性	きしょう	名	性情、秉性、气质
気象	きしょう	名	气象
傷	きず	他下一	伤；瑕疵；有损于、缺点、污点
築く	きずく	他五	修筑、构筑；确立、确定
絆	きずな	名	栓东西的绳索；情谊、纽带；羁绊
期する	きする	サ変	决定期限；期待；确信
帰する	きする	サ変	归结、归根到底；归罪于、归咎
既製	きせい	名	做好的、现成的
規制	きせい	名，サ変	规定、规章、限制、控制
犠牲	ぎせい	名	牺牲
奇跡	きせき	名	奇迹
軌跡	きせき	名	轨迹；经历；车辙
季節	きせつ	名	季节
着せる	きせる	他下一	给……穿上；镀上；嫁祸，归罪
基礎	きそ	名	基础
起訴	きそ	名，サ変	起诉
競う	きそう	自他五	竞争、竞赛
規則	きそく	名	规则
北	きた	名	北、北方、北面
気体	きたい	名	气体
期待	きたい	名，サ変	期待、期望
鍛える	きたえる	他下一	锻、冶炼；锻炼
来す	きたす	他五	招致、引起
気立て	きだて	名	气质、性情
汚い	きたない	形	脏的、不干净的；卑劣；卑鄙的；吝啬的
来る	きたる	連体	下一个
基地	きち	名	基地
貴重	きちょう	形動	贵重、宝贵
きちんと	きちんと	副	干警、整洁地；正确地；如期地；恰当地、妥切地
きつい	きつい	形	严厉、苛刻的；强烈的；严厉；紧的、瘦小
切っ掛け	きっかけ	名	起首、时机、契机
気づく	きづく	自五	注意到、意识到
ぎっしり	ぎっしり	副	挤得满满地
切手	きって	名	邮票
きっと	きっと	副	一定、毫无疑问地；严厉地、严肃地
狐	きつね	名	狐狸、狡猾的人
切符	きっぷ	名	票、券
規定	きてい	名，サ変	规定
軌道	きどう	名	天体运行的轨道；铁轨、路轨；（事物运行的）轨道
危篤	きとく	名	病笃、危笃
記入	きにゅう	名，サ変	写入、记入
絹	きぬ	名	丝绸、丝织品
記念	きねん	名，サ変	纪念
昨日	きのう	名	昨天；不久以前、过去
機能	きのう	名，サ変	机能
気の毒	きのどく	名，形動	可怜的；对不起、抱歉
気迫	きはく	名	气概、积极性、气魄
希薄	きはく	名，形動	稀薄
奇抜	きばつ	名，形動	奇特的、特别的
基盤	きばん	名	基础、底子
厳しい	きびしい	形	严格的；严酷的；厉害的；严峻的
寄付	きふ	名，サ変	捐助、捐赠
気風	きふう	名	风气、风尚、习气
気分	きぶん	名	心情、情绪；身体状况；性情；气氛、空气
規模	きぼ	名	规模
希望	きぼう	名	希望
基本	きほん	名	基本
気まぐれ	きまぐれ	名，形動	一时兴起；变化无常、善变
決まる	きまる	自五	决定；当然、必定
君	きみ	名	用于同辈或晚辈的第二人称；君主
気味	きみ	名	心情；倾向
義務	ぎむ	名	义务
決める	きめる	他下一	决定；决心；定居；做好；以……为习惯
肝	きも	名	肝；胆量
気持ち	きもち	名	感情；情绪；心境；感觉；一点点
着物	きもの	名	衣服；和服
疑問	ぎもん	名	疑问
客	きゃく	名	客人
逆	ぎゃく	名	正相反
脚色	きゃくしょく	名，サ変	改写成脚本；粉饰
逆説	ぎゃくせつ	名	逆说、反论
虐待	ぎゃくたい	名，サ変	虐待
逆転	ぎゃくてん	名，サ変	逆转
脚本	きゃくほん	名	台本、脚本
客観	きゃっかん	名	客观
休暇	きゅうか	名	休假
救急	きゅうきゅう	名	急救
窮屈	きゅうくつ	形動	狭小；拘泥于形式；压抑；不富裕
休憩	きゅうけい	名，サ変	休息、歇
急激	きゅうげき	形動	急剧
急行	きゅうこう	名，サ変	走得快；快速列车
休講	きゅうこう	名，サ変	停课
休止	きゅうし	名，サ変	休止、停止
休日	きゅうじつ	名	休息日
吸収	きゅうしゅう	名，サ変	吸取；同化、合并
急所	きゅうしょ	名	致命处；要点、要害
救助	きゅうじょ	名，サ変	救助
急進	きゅうしん	名，サ変	快速向前；激进
旧跡	きゅうせき	名	古迹、旧迹
急増	きゅうぞう	名，サ変	急剧增长
急速	きゅうそく	名，サ変	休息
及第	きゅうだい	名，サ変	及第
窮地	きゅうち	名	窘境、困境
急場	きゅうば	名	危急、紧急
急病	きゅうびょう	名	疾病
給与	きゅうよ	名，サ変	发给、供给；工资、薪水
休養	きゅうよう	名，サ変	修养
給料	きゅうりょう	名	报酬、薪水
清い	きよい	形	不混浊；纯粹的
今日	きょう	名	今天
器用	きよう	形動	灵活；不出差错
脅威	きょうい	名	威胁
教育	きょういく	名	教育
強化	きょうか	名，サ変	强化
境界	きょうかい	名	地界、界限
協会	きょうかい	名	协会
教会	きょうかい	名	教会
教科書	きょうかしょ	名	教科书
共感	きょうかん	名，サ変	同感
競技	きょうぎ	名，サ変	比赛；体育项目
協議	きょうぎ	名，サ変	协议、协商
行儀	ぎょうぎ	名	礼貌、修养；（合乎礼节的）举止
供給	きょうきゅう	名，サ変	供应、供给；平衡
境遇	きょうぐう	名	处境
教訓	きょうくん	名	教训
狂言	きょうげん	名	狂言（日本的一种古典滑稽戏）
恐慌	きょうこう	名	恐慌；经济危机
強行	きょうこう	名，サ変	强行
教材	きょうざい	名	教材
教師	きょうし	名	教师
行事	ぎょうじ	名	仪式；活动
教授	きょうじゅ	名，サ変	传授；教授
恐縮	きょうしゅく	名，サ変	对不起、惶恐
強制	きょうせい	名，サ変	强制
行政	ぎょうせい	名	行政
業績	ぎょうせき	名	成果、功绩
競争	きょうそう	名，サ変	竞争、竞赛
競走	きょうそう	名，サ変	赛跑
兄弟	きょうだい	名	兄弟、姐妹；把兄弟、哥们
境地	きょうち	名	境地、境界
強調	きょうちょう	名，サ変	强调
協調	きょうちょう	名，サ変	协调
共通	きょうつう	形動，名，サ変	共通
郷土	きょうど	名	乡土；故乡
共同	きょうどう	名，サ変	共同
脅迫	きょうはく	名，サ変	威胁
恐怖	きょうふ	名，サ変	恐怖
興味	きょうみ	名	兴趣
業務	ぎょうむ	名	业务、工作
共鳴	きょうめい	名，サ変	共鸣
教養	きょうよう	名	教养、修养
郷里	きょうり	名	家乡、故乡
協力	きょうりょく	名，サ変	协作
行列	ぎょうれつ	名，サ変	游行队伍；排队
虚栄	きょえい	名	虚荣
許可	きょか	名，サ変	许可
曲	きょく	名	乐曲；趣味
曲芸	きょくげい	名	杂技
曲折	きょくせつ	名，サ変	曲折；波折
曲線	きょくせん	名	曲线
極端	きょくたん	名，形動	极限、极端
巨人	きょじん	名	高个头
御する	ぎょする	サ変	驾驭；支配
拒絶	きょぜつ	名，サ変	拒绝
拠点	きょてん	名	据点
去年	きょねん	名	去年
拒否	きょひ	名，サ変	谢绝
虚無	きょむ	名	虚无
清らか	きよらか	形動	清洁、干净；纯洁
距離	きょり	名	距离
嫌い	きらい	形動，名，サ変	不喜欢；有点；（用否定式表示）不管
嫌う	きらう	自五	憎恶；敬而远之、回避；（用否定式表示）不管
きらきら	きらきら	副	闪烁、耀眼
霧	きり	名	雾
義理	ぎり	名	道理、对人的义务；交往；与配偶者家人的关系
切り下げる	きりさげる	他下一	降低；降价
切り捨てる	きりすてる	他下一	切除；省略；削减
規律	きりつ	名	规则；秩序
切り開く	きりひらく	他五	切开；开拓；修新路；开辟进路
器量	きりょう	名	脸面；姿色、容貌；才能
気力	きりょく	名	毅力；精力、活力
切る	きる	他五	切、剪；被刀划受伤；接触关系；使中断；限于；减少、降低；去掉水份等；改变方向；开始；勇猛向前；穿过；按快门
着る	きる	他上一	穿；背负
綺麗	きれい	形動	美丽；干净；收缴麻利；没有污点；完全
切れる	きれる	自下一	被切断；锋利；断绝关系；中断；终结、完了；结束；低于；反应敏捷
記録	きろく	名，サ変	记录
議論	ぎろん	名，サ変	议论
際立つ	きわだつ	自五	显眼、显著
極まる，窮まる	きわまる	自五	极限、之至；困窘、难办
禁煙	きんえん	名，サ変	禁烟、戒烟
金額	きんがく	名	金额
近眼	きんがん	名	近视；眼光短浅的人
緊急	きんきゅう	名，形動	紧急
近況	きんきょう	名	近况
金庫	きんこ	名	保险库；国库
均衡	きんこう	名	均衡、平衡
近郊	きんこう	名	近郊
銀行	ぎんこう	名	银行
禁止	きんし	名，サ変	禁止
近所	きんじょ	名	附近、近邻
禁じる	きんじる	他上一	禁止
金属	きんぞく	名	金属
近代	きんだい	名	近代
緊張	きんちょう	名，サ変	身心紧张；对立关系
均等	きんとう	形動	均等
筋肉	きんにく	名	肌肉
金箔	きんぱく	名	金箔；贴金
緊迫	きんぱく	名，サ変	紧迫、紧急
勤勉	きんべん	名，形動	勤奋、勤劳
緊密	きんみつ	形動	紧密
勤務	きんむ	名，サ変	（在公司等）上班、任职、工作
禁物	きんもつ	名	禁止的事情、忌讳的东西
金融	きんゆう	名	金融
具合	ぐあい	名	健康状态；事态、情况；做法；方便、合适
食い込む	くいこむ	自五	勒进去；陷入；侵占
食い違う	くいちがう	自五	相互不同；不一致
食い付く	くいつく	自五	鱼上钩；紧紧咬住不放；起劲、热心
悔いる	くいる	他下一	后悔、懊悔
食う	くう	他五	生活；虫咬；紧逼对方；侵入对方的势力范围；打倒强手；费时、费钱；上年纪；遭到
空間	くうかん	名	空间
空気	くうき	名	大气；气氛
空虚	くうきょ	名，形動	空虚；空洞
空襲	くうしゅう	名，サ変	空袭
空席	くうせき	名	空位；空职位
偶然	ぐうぜん	名，形動，副	偶然、偶尔
空想	くうそう	名，サ変	空想
空白	くうはく	名	纸面的空栏；什么也没有
区画	くかく	名	（土地、街道的）区划、界线
苦学	くがく	名，サ変	苦读；勤工俭学
区間	くかん	名	公路、铁路的某一地点到某一地点之间
釘	くぎ	名	钉子
苦境	くきょう	名	困境
区切る	くぎる	他五	打标点符号、分段；在事物之间划出界线
括る	くくる	他五	捆在一起；扎、绑
潜る	くぐる	自五	从下面穿过；趁不注意逃走
草	くさ	名，接頭	草、饲草；非正式
臭い	くさい	形	臭；可疑；造作、故意；有气味；派头、样子
鎖	くさり	名	链子；关系、缘分
腐る	くさる	自五	腐败；金属受腐蚀；堕落；情绪低落
挫く	くじく	他五	扭伤；挫败
挫ける	くじける	自下一	扭伤；气馁、沮丧
籤引き	くじびき	名，サ変	抽签
くしゃくしゃ	くしゃくしゃ	副，形動，サ変	乱蓬蓬；皱巴巴；心烦意乱
くしゃみ	くしゃみ	名，サ変	打喷嚏
苦情	くじょう	名	提意见、投诉
苦心	くしん	名，サ変	苦心、用心良苦
屑	くず	名	废物；没用的东西
愚図愚図	ぐずぐず	副	慢手慢脚的样子；发牢骚的样子
崩す	くずす	他五	敲坏；使凌乱、散乱；换成零钱；把字写的潦草
薬	くすり	名	药、益处
崩れる	くずれる	自下一	崩溃、倒塌；紊乱；走形、凌乱；天气变坏；换成零钱；行情急剧下落
癖	くせ	名	癖性；特征；（头发）卷儿、（衣服）褶儿
管	くだ	名	管子
具体	ぐたい	名	具体
砕く	くだく	他五	弄碎；烦心；尽力；使之通俗
砕ける	くだける	自下一	破碎；气势减弱；和蔼、平易
下さい	ください	連	请给我……；请帮我……
下さる	くださる	他五	“くれる”的尊敬语
下す	くだす	他五	赐予、给予；作出判断、下达命令；实行、实施；拉肚子；打败
草臥れる	くたびれる	自下一	疲劳；穿旧、用旧
果物	くだもの	名	水果
下らない	くだらない	連	没有价值、不值一提
下る	くだる	自五	往低处移动；低于；从中心地朝四周去；下（命令、判决等）；时代变迁；拉肚子；投降
口	くち	名	人或是动物的嘴；像嘴一样张开的部分；语言、说法；传闻；味觉；抚养的人数；工作等安定之出；申请、照会；分担部分；种类
愚痴	ぐち	形動，名，サ変	牢骚、怨言
口先	くちさき	名	嘴边；口头、嘴上
口出し	くちだし	名	插嘴；表述自己的意见
嘴	くちばし	名	鸟嘴、喙
唇	くちびる	名	嘴唇
口調	くちょう	名	语调
靴	くつ	名	鞋
苦痛	くつう	名	痛苦；苦恼
覆す	くつがえす	他五	打翻；推翻
くっきり	くっきり	副，サ変	清楚、分明；与众不同
屈する	くっする	サ変	屈服
屈折	くっせつ	名，サ変	弯曲；光、电磁波、声波的反射；被歪曲、异常
ぐったり	ぐったり	副，サ変	筋疲力尽
寛ぐ	くつろぐ	自五	舒适；不拘束、随便
くどい	くどい	形	话多、冗长；颜色深、味道浓
国	くに	名	国家；地方；故乡
苦悩	くのう	名，サ変	苦恼
配る	くばる	他五	分配；配置；用心、注意
首	くび	名	颈部；生命；免职、解雇
工夫	くふう	名，サ変	想方设法、动脑筋
区別	くべつ	名，サ変	差异
窪む	くぼむ	自五	掉落、塌陷
熊	くま	名，接頭	熊；大的
組合	くみあい	名	合作社、工会
組み合わせ	くみあわせ	名	一套；比赛的编组
組み立てる	くみたてる	他下一	组装
汲み取る	くみとる	他五	舀；体察、体谅
汲む	くむ	他五	舀起液体；摄取；体谅
酌む	くむ	他五	倒入、饮
組む	くむ	自他五	组装；交叉；成为朋友、合伙；对战
雲	くも	名	云；模糊
蜘蛛	くも	名	蜘蛛
曇る	くもる	自五	天空多云；模糊；发愁
悔しい	くやしい	形	后悔；窝囊
悔やむ	くやむ	他五	后悔；悼念
くよくよ	くよくよ	副，サ変	气量小、想不开、烦恼
倉，蔵	くら	名	仓库
位	くらい	副助	大致的数量；（带轻蔑的语气）至少；差不多
暗い	くらい	形	昏暗；颜色不明朗；心情沉重；不熟悉、生疏；不光彩的
暮らす	くらす	自五	生活；维持生活；度过时光
比べる，較べる	くらべる	自他下一	比较；比高低
晦ます，暗ます	くらます	他五	隐藏；欺骗
繰り上げる	くりあげる	他下一	提前
繰り返す	くりかえす	他五	反反复复
繰り下げる	くりさげる	他下一	延期
来る	くる	力変	来；来访；季节、时间到来；送到；引来；来源于；起因；变成某种状态
狂う	くるう	自五	心态失常；不正常、出故障；落空
苦しい	くるしい	形	痛苦；辛苦；艰难；困惑；勉强
苦しむ	くるしむ	自五	痛苦；烦恼；难于；费尽周折
車	くるま	名	车轮；汽车、马车
包む	くるむ	他五	裹、包
くれぐれ	くれぐれ	副	恳切地、衷心地
暮れる	くれる	自下一	天晚；季节过去；想不出、不知如何
呉れる	くれる	他下一	别人给自己；别人帮助自己做某事
黒	くろ	名	黑色；值得怀疑
黒い	くろい	形	黑的；脸色黑；被弄脏；阴暗；心地肮脏；有犯罪嫌疑；不吉祥的
苦労	くろう	名，サ変	费周折、担心
玄人	くろうと	名	内行、行家
加える	くわえる	他下一	加算；增加；吸收为伙伴；给予
詳しい	くわしい	形	详细的；精通
食わせる	くわせる	他下一	喂、给别人吃；抚养；欺骗、施计；给予
企てる	くわだてる	他下一	计划、试图、打算
加わる	くわわる	自五	增加；增多；加入
軍事	ぐんじ	名	军事
訓読み	くんよみ	名	训读
訓練	くんれん	名，サ変	训练
毛	け	名	毛
経緯	けいい	名	经纬；事情的原委
敬意	けいい	名	敬意
経営	けいえい	名，サ変	经营
敬遠	けいえん	名，サ変	敬而远之、躲避
経過	けいか	名，サ変	经历；经过
警戒	けいかい	名，サ変	警戒
軽快	けいかい	形動	轻快的
計画	けいかく	名，サ変	计划、试图、打算
景気	けいき	名	经济状况；活跃
契機	けいき	名	契机、开端
経験	けいけん	名，サ変	经验
稽古	けいこ	名，サ変	手艺、演技等的练习
敬語	けいご	名	用于表示敬意的语言
傾向	けいこう	名	倾向、趋势；性格、趋向
警告	けいこく	名，サ変	警告
掲載	けいさい	名，サ変	刊登
経済	けいざい	名	经济；节约
警察	けいさつ	名	警察
計算	けいさん	名，サ変	计算；计算、算盘、打算
掲示	けいじ	名，サ変	公布、告示
形式	けいしき	名	样式、款式；形式上的、表面上的
傾斜	けいしゃ	名，サ変	倾斜；偏向
芸術	げいじゅつ	名	艺术
敬称	けいしょう	名	敬称
継承	けいしょう	名，サ変	继承
形勢	けいせい	名	形式
形成	けいせい	名，サ変	形成
継続	けいぞく	名，サ変	继续
軽率	けいそつ	形動	轻率、草率
携帯	けいたい	名，サ変	携带；手机
系統	けいとう	名	系统；流派、党派
傾倒	けいとう	名，サ変	致力、倾注；倾倒
芸能	げいのう	名	在学问、艺术、技能等方面的突出才能
軽薄	けいはく	形動	轻且薄；轻浮、轻薄
刑罰	けいばつ	名，サ変	制裁
経費	けいひ	名	经费
軽蔑	けいべつ	名，サ変	轻蔑、蔑视
刑務所	けいむしょ	名	监狱
契約	けいやく	名	契约、合同
経由	けいゆ	名，サ変	经由、途径
形容詞	けいようし	名	形容词
形容動詞	けいよう動詞	名	形容动词
経理	けいり	名	财会业务
計略	けいりゃく	名	计略
痙攣	けいれん	名，サ変	痉挛、抽筋
経路	けいろ	名	路途、路径
怪我	けが	名，サ変	受伤；过失
汚す	けがす	他五	弄脏、玷污
汚れる	けがれる	自下一	变脏；污染；肮脏
劇	げき	名	话剧、戏剧；戏剧性的
劇場	げきじょう	名	剧场
激励	げきれい	名，サ変	激励、鼓励
景色	けしき	名	景色
下宿	げしゅく	名，サ変	寄宿
化粧	けしょう	名，サ変	化妆；装饰、点缀
消す	けす	他五	灭火；关灯、关煤气等；删除；包盖、吸收；消失；杀死
下水	げすい	名	下水、脏水
削る	けずる	他五	刀削；削减
桁	けた	名	建筑物、桥等的梁；位数
下駄	げた	名	木屐
けたたましい	けたたましい	形	尖锐的、嘈杂的
けち	けち	名，形動	小气；粗制滥造的；不值一提的
血圧	けつあつ	名	血压
決意	けつい	名，サ変	坚定自己的想法、决心
血液	けつえき	名	血液
結果	けっか	名	结果
欠陥	けっかん	名	不完全之处、缺陷
血管	けっかん	名	血管
決議	けつぎ	名，サ変	决议
月給	げっきゅう	名	月工资
結局	けっきょく	名，副	结局、结尾；最终
結構	けっこう	名，形動	构造；非常好的、无懈可击的；足够的、满足的；不需要
決行	けっこう	名，サ変	坚决执行
血行	けっこう	名	血液循环
月光	げっこう	名	月光
結婚	けっこん	名，サ変	结婚
傑作	けっさく	名，形動	杰作；离奇、滑稽的
決して	けっして	副	决不
月謝	げっしゃ	名	学费
決勝	けっしょう	名，サ変	决胜
結晶	けっしょう	名	结晶、成果
決心	けっしん	名，サ変	决心、下决心
決する	けっする	サ変	决定
欠席	けっせき	名，サ変	缺席
決戦	けっせん	名，サ変	决战、决赛
結束	けっそく	名，サ変	捆扎；团结
決断	けつだん	名，サ変	下定决心
決定	けってい	名	决定
欠点	けってん	名	缺点
蹴っ飛ばす	けっとばす	他五	踢出；拒绝
月賦	げっぷ	名	分月付款
欠乏	けつぼう	名，サ変	缺乏
結末	けつまつ	名	结尾、结局；最终结果
結論	けつろん	名	结论
貶す	けなす	他五	诽谤、贬人
解熱	げねつ	名，サ変	退烧
懸念	けねん	名，サ変	担心、惦念
気配	けはい	名	迹象、情况；市场的行情、状况
仮病	けびょう	名	假病、装病
下品	げひん	形動	低级趣味
煙い	けむい	形	（烟）呛人
煙	けむり	名	烟；像烟似的
獣	けもの	名	野兽、禽兽
げらげら	げらげら	副	哈哈大笑状
下痢	げり	名，サ変	腹泻
蹴る	ける	他五	用脚踢；不满地从座位上站起来；拒绝要求
けれども	けれども	接続，終助	表示转折关系；没有特别意义、仅仅表示前后话题的连接；作为终助词、用于表示谦逊的心情
険しい	けわしい	形	险峻的；可怕的、险恶的；有危险的、艰难的
原案	げんあん	名	原来的想法、原来的方案
権威	けんい	名	权威
原因	げんいん	名	原因
現役	げんえき	名	在位的、在职的；应届生
検閲	けんえつ	名	检查、审查（货物、出版物等）；阅兵
喧嘩	けんか	名，サ変	争吵；打架
原価	げんか	名	原价、成本价、进货价
限界	げんかい	名	界限、极限
見学	けんがく	名，サ変	实地参观
厳格	げんかく	形動	严格
玄関	げんかん	名	大门
元気	げんき	名，形動	有活力、健康
研究	けんきゅう	名，サ変	研究、钻研
献金	けんきん	名，サ変	捐款
現金	げんきん	名，形動	现金；贪图眼前利益、势利眼
原型	げんけい	名	原型
権限	けんげん	名	权限
言語	げんご	名	语言
健康	けんこう	名，形動	身体状况；健康
原稿	げんこう	名	稿子
検査	けんさ	名，サ変	检查
現在	げんざい	名	现在；当时、截至某事
検索	けんさく	名，サ変	检索、查找
検察	けんさつ	名，サ変	检查、调查罪犯
原子	げんし	名	原子；原子弹
原始	げんし	名	原始
見識	けんしき	名	见识；气度、架子
堅実	けんじつ	形動	可靠、稳妥
現実	げんじつ	名	现实
研修	けんしゅう	名，サ変	进修
厳重	げんじゅう	形動	严密、严格
謙譲	けんじょう	名，サ変	谦让、谦逊
減少	げんしょう	名，サ変	减少
現象	げんしょう	名	现象
現状	げんじょう	名	现状
牽制	けんせい	名，サ変	牵制
建設	けんせつ	名，サ変	建造；设立、创立
健全	けんぜん	形動	健全、身心健康；坚实
元素	げんそ	名	元素
建造	けんぞう	名，サ変	建造
幻想	げんそう	名	幻想
原則	げんそく	名	原则
謙遜	けんそん	形動，名，サ変	谦逊
現代	げんだい	名	现代
現地	げんち	名	现场；此地
建築	けんちく	名，サ変	建筑
検定	検定	名，サ変	审定、验定
限定	げんてい	名，サ変	限定
原点	げんてん	名	原点、基本点
限度	げんど	名	限度
検討	けんとう	名，サ変	调查研究
見当	けんとう	名	大概的方向；估价、推测；大约
現場	げんば	名	现场、事情发生的场所；施工的场所
原爆	げんばく	名	原子弹
顕微鏡	けんびきょう	名	显微镜
見物	けんぶつ	名，サ変	参观名胜；旁观
憲法	けんぽう	名	宪法
厳密	げんみつ	形動	严密地
懸命	けんめい	形動	拼命努力
賢明	けんめい	形動	贤明、高明
幻滅	げんめつ	名，サ変	幻灭
倹約	けんやく	形動，サ変	节俭、朴素
権利	けんり	名	权利
原理	げんり	名	原理
原料	げんりょう	名	原料
権力	けんりょく	名	权利
言論	げんろん	名	言论
碁	ご	名	围棋
恋	こい	名	恋情
鯉	こい	名	鲤鱼
濃い	こい	形	颜色深；浓度、密度高；味道浓；关系深
故意	こい	名	故意
語彙	ごい	名	词汇
恋しい	こいしい	形	怀念、爱慕
恋人	こいびと	名	恋人
請う	こう	他五	请求、希望
行為	こうい	名	行为
好意	こうい	名	好意、善意
厚意	こうい	名	厚意、盛情
合意	ごうい	名，サ変	同意、达成协议
光陰	こういん	名	光阴
強引	ごういん	形動	强行、强迫
豪雨	ごうう	名	大雨、暴雨
幸運	こううん	形動	幸运
光栄	こうえい	名，形動	光荣
公園	こうえん	名	公园
後援	こうえん	名，サ変	后援、支援
講演	こうえん	名，サ変	讲演
公演	こうえん	名，サ変	公演
硬化	こうか	名，サ変	硬化；强硬
効果	こうか	名	效果
降下	こうか	名，サ変	下降
硬貨	こうか	名	硬币
後悔	こうかい	名，サ変	后悔
公開	こうかい	名，サ変	公开、对外开放
航海	こうかい	名，サ変	航海
公海	こうかい	名	公海
公害	こうがい	名	公害
合格	ごうかく	名，サ変	合格
交換	こうかん	名，サ変	交换
好感	こうかん	名	好感
好奇	こうき	名	好奇
広義	こうぎ	名	广义
講義	こうぎ	名，サ変	讲课
抗議	こうぎ	名，サ変	抗议
好奇心	こうきしん	名	好奇心
高級	こうきゅう	名，形動	级别高的；档次高的
公共	こうきょう	名	公共
好況	こうきょう	民	繁荣，好景象
工業	こうぎょう	名	工业
航空	こうくう	名	航空
合計	ごうけい	名，サ変	合计
攻撃	こうげき	名，サ変	攻击、非难
豪傑	ごうけつ	名	豪杰
貢献	こうけん	名，サ変	贡献
口語	こうご	名	口语
孝行	こうこう	名，サ変	孝顺
高校	こうこう	名	高中
広告	こうこく	名	广告
交差	こうさ	名，サ変	交叉
講座	こうざ	名	讲座
交際	こうさい	名，サ変	交际
功罪	こうざい	名	功过
工作	こうさく	名，サ変	手工；活动、工作；有计划的行为
考察	こうさつ	名，サ変	考虑、调查
降参	こうさん	名，サ変	投降；折服、认输
公私	こうし	名	公私；公私不分
講師	こうし	名	讲师；讲演者
工事	こうじ	名，サ変	工事
公式	こうしき	名	数学公式；正式
口実	こうじつ	名	借口
公衆	こうしゅう	名	公众
講習	こうしゅう	名，サ変	讲习、学习
交渉	こうしょう	名，サ変	交涉；关系
工場	こうじょう	名	工厂
向上	こうじょう	名，サ変	向上
強情	ごうじょう	名，形動	顽固、倔强
講じる	こうじる	他下一	讲授；采取
更新	こうしん	名，サ変	更新
後進	こうしん	名	后来者；落后
香水	こうすい	名	香水
降水	こうすい	名	降水
洪水	こうずい	名	洪水；很多
公正	こうせい	名，形動	公正
校正	こうせい	名，サ変	校对、校正
構成	こうせい	名，サ変	构成、组成
合成	ごうせい	名，サ変	合成
功績	こうせき	名	业绩、贡献
構想	こうそう	名，サ変	构思、构想
高層	こうそう	名	高空；高层
構造	こうぞう	名	构造
高速	こうそく	名	高速
交代，交替	こうたい	名，サ変	替换、交接、轮流
後退	こうたい	名，サ変	后退；衰退、倒退
光沢	こうたく	名	光泽
耕地	こうち	名	耕地
好調	こうちょう	名，形動	顺利、情况良好
交通	こうつう	名	交通；客货的输送
公定	こうてい	名	公认的、法定的
肯定	こうてい	名，サ変	肯定
好転	こうてん	名，サ変	好转
高等	こうとう	名，形動	高等的、高级的；高档的
行動	こうどう	名，サ変	行动
講堂	こうどう	名	讲堂、礼堂
合同	ごうどう	名，サ変	结合、合一、统一
購入	こうにゅう	名，サ変	购买
公認	こうにん	名，サ変	公认、正式许可
後任	こうにん	名	后任
後輩	こうはい	名	低年级同学、（比自己）后参加工作的人
荒廃	こうはい	名，サ変	荒芜；（精神）颓废
購買	こうばい	名，サ変	购买
勾配	こうばい	名	倾斜；坡度
後半	こうはん	名	后半
交番	こうばん	名	轮班；派出所
公表	こうひょう	名，サ変	公开发表、公布
好評	こうひょう	名	好评
幸福	こうふく	名，形動	幸福
興奮	こうふん	名，サ変	兴奋
公平	こうへい	名，形動	公平
合弁	ごうべん	名，サ変	共同经营
候補	こうほ	名	候补
広報	こうほう	名，サ変	宣传、报道
被る	こうむる	他五	遭受损害或屈辱；得到恩惠；承蒙
公用	こうよう	名	公用、因公
行楽	こうらく	名	游览、游玩
合理	ごうり	名	合理、科学的
交流	こうりゅう	名，サ変	交流
合流	ごうりゅう	名，サ変	汇合；联合、合并
考慮	こうりょ	名，サ変	考虑、调查
高齢	こうれい	名	高龄、年迈
声	こえ	名	人或是动物所发出的声音；语言；意见；气息
越える，超える	こえる	自下一	超过；超越；穿越
肥える	こえる	自下一	肥胖；肥沃；有判断能力；要求高
氷	こおり	名	冰
凍る	こおる	自五	结冰
誤解	ごかい	名，サ変	误解
焦がす	こがす	他五	烧焦；焦急
小型，小形	こがた	名	小型
小切手	こぎって	名	支票
呼吸	こきゅう	名，サ変	呼吸；步调；诀窍、窍门
故郷	こきょう	名	故乡
漕ぐ	こぐ	他五	划船；踩踏船
国語	こくご	名	国文、语文
国際	こくさい	名	国际
国籍	こくせき	名	国籍
国土	こくど	名	国土
告白	こくはく	名，サ変	自白、坦白
告発	こくはつ	名，サ変	告发、检举、提诉
国民	こくみん	名	国民
穀物	こくもつ	名	谷物
極楽	ごくらく	名	极乐世界、安乐
焦げる	こげる	自下一	烧焦
此処	ここ	代	这里；最近；这时；目前的阶段、范围；这点
午後	ごご	名	午后、下午
心地	ここち	名	感觉、心境
心	こころ	名	精神；想法；心情、感觉；体贴新；真心；爱情；意义
心当たり	こころあたり	名	估计、猜想
心得	こころえ	名	理解、经验；规则、指示
心掛け	こころがけ	名	留意、留心
志す	こころざす	他五	以……为目标、决心
試みる	こころみる	他上一	尝试、企图
心持ち	こころもち	名，副	心情、心境；略微有点
心行く	こころゆく	自五	尽情、尽兴
快い	こころよい	形	舒服、高兴；病情见好
腰	こし	名	腰；弹力、粘度
個室	こしつ	名	单人间
こじつける	こじつける	他下一	牵强附会、歪曲
故障	こしょう	名，サ変	故障
後生	ごしょう	名	来世；表示恳求
拵える	こしらえる	他下一	制作；准备、筹措；装扮；作假；拥有
拗れる	こじれる	自下一	别扭、乖僻；复杂、（病）久治不愈
個人	こじん	名	个人
越す	こす	他五	穿过、通过；度过时光；越过高峰；经过；追赶；搬家；来、去的敬语
梢	こずえ	名	树梢、枝头
擦る	こする	他五	擦
個性	こせい	名	个性
午前	ごぜん	名	上午
挙って	こぞって	副	全、都
固体	こたい	名	固体
古代	こだい	名	古代
答える	こたえる	他下一	回答；解答
拘る	こだわる	自五	讲究、在乎、固执
ご馳走	ごちそう	名，サ変	款待；佳肴
誇張	こちょう	名，サ変	夸张
此方	こちら	代	这里；这个；自己
骨	こつ	名	死者的骨灰；要领
国家	こっか	名	国家
国会	こっかい	名	国会
小遣い	こづかい	名	零花钱
骨格	こっかく	名	骨架；体格
国境	こっきょう	名	国境
滑稽	こっけい	名，形動	滑稽
ごっこ	ごっこ	造語	儿童玩的游戏
こつこつ	こつこつ	副	勤奋、刻苦
固定	こてい	名，サ変	固定
古典	こてん	名	古典
事	こと	名	事情；理由；工作；内容
琴	こと	名	琴
事柄	ことがら	名	事情、情况
孤独	こどく	名，形動	孤独
悉く	ことごとく	名，副	一切、全都
殊更	ことさら	副	特别、格外；故意
今年	ことし	名	今年
如し	ごとし	助動	如同、像
言付け	ことづけ	名	口信、托付
異なる	ことなる	自五	不同；特别
殊に	ことに	副	特别地
言葉	ことば	名	语言；单词、语句、表达；说法、讲法；所说的话
子供	こども	名	自己的儿女；年幼者
諺	ことわざ	名	成语、典故、谚语
断る	ことわる	他五	谢绝、拒绝；预先通知；道歉、解释
粉	こな	名	粉末
こなす	こなす	他五	捣碎、压碎；消化；处理好、做好
こなれる	こなれる	自下一	消化；熟练；通晓世故人情
捏ねる	こねる	他下一	捏；强词夺理
この	この	連体	这、这个；这件（事）
この頃	このごろ	名	最近
好もしい	このましい	形	受欢迎的；令人满意的
好む	こにむ	他五	爱好、喜欢
拒む	こばむ	他五	拒绝、不承认；组织
ご飯	ごはん	名	饭
語尾	ごび	名	词尾、结尾词；句子的结尾
媚びる	こびる	自上一	献媚、讨好
瘤	こぶ	名	瘤；碍事的人
ご無沙汰	ごぶさた	名，サ変	疏于问候、久违
拳	こぶし	名	拳头
零す	こぼす	他五	洒、掉（水、饭粒、眼泪等）；抱怨、发牢骚
零れる	こぼれる	自下一	漏、落、掉；溢出；露出
駒	こま	名	马、驹；日本象棋棋子；木垫
細かい	こまかい	形	细微；严密的、详细的；会打算、小气
誤魔化す	ごまかす	他五	骗人；撒谎；敷衍了事、蒙混过关；骗取
困る	こまる	自五	处于困境、倒霉；不知所措
ごみ	ごみ	名	垃圾
込み上げる	こみあげる	自下一	涌现、涌上来；想吐
込む	こむ	自五	拥挤；复杂、精雕细刻
米	こめ	名	稻米
込める	こめる	他下一	填装；包含；全力以赴、专心致志
御免	ごめん	名	原谅；拒绝；免职
籠(も)る	こもる	自五	隐居、隐藏；闭门不出；包含；烟等弥漫于某场所；声音不清楚
顧問	こもん	名	顾问、当顾问
小屋	こや	名	简陋的小房子
肥やす	こやす	他五	施肥；发不义之财；增强判断力等
今宵	こよい	名	今晚
雇用	こよう	名，サ変	雇用
御用	ごよう	名	事情；订货；逮捕
暦	こよみ	名	历法
堪える	こらえる	他下一	忍耐、憋住
娯楽	ごらく	名	娱乐
凝らす	こらす	他五	使凝固、使僵硬；使集中
孤立	こりつ	名，サ変	孤立
五里霧中	ごりむちゅう	名	五里雾中
懲りる	こりる	自上一	接受了……的教训、吃了苦头再不想干
凝る	こる	自五	肌肉变硬；热衷于；讲究、精心制作
此れ，是	これ	代，感	此、这；现在；这人（用于家人或下属）；这儿；喂
頃	ころ	名	时期；时机
頃	ごる	接尾	左右；恰好、适时
転がす	ころがす	他五	滚动；推倒；放置
転がる	ころがる	自五	滚动；倒下；横躺；随意搁置着
ごろごろ	ごろごろ	副，サ変	汽车、地震等的声音；滚动的样子；随处可见；混入异物、沙子等；懒洋洋
殺す	ころす	他五	杀害；压抑；埋没
転ぶ	ころぶ	自五	跌倒；滚转
怖い	こわい	形	恐惧、恐怖、可怕、吓人
こわごわ	こわごわ	副，サ変	提心吊胆、心惊胆战
壊す	こわす	他五	破坏、损坏；损害、损伤；破坏、砸锅
声高	こわだか	形動	高声
強張る	こわばる	自五	生硬、变硬
壊れる	こわれる	自下一	乱七八糟、支离破碎；失败、流产；出故障
根気	こんき	名	韧性、毅力
根拠	こんきょ	名	理由、根据
混血	こんけつ	名	混血
今月	こんげつ	名	本月、这个月
今後	こんご	名	今后、将来
言語	ごんご	名	语言
混交	こんこう	名，サ変	混杂
混合	こんごう	名，サ変	混合
混雑	こんざつ	名，サ変	拥挤、混乱
今週	こんしゅう	名	本周、这一周
根性	こんじょう	名	性质、气质；毅力
今度	こんど	名	这次、这回；最近、上次；下次
混同	こんどう	名，サ変	混同、混淆
困難	こんなん	名，形動	困难的、棘手的
今日	こんにち	名	今天；当代、现代
今晩	こんばん	名	今晚、津液
根本	こんぽん	名	基本、根本、本质
今夜	こんや	名	今夜
婚約	こんやく	名，サ変	订婚、婚约
混乱	こんらん	名，サ変	混乱
困惑	こんわく	名，サ変	困惑、为难
差	さ	名	差别；差数
際	さい	名	之际、时
最悪	さいあく	名	最糟、最不利
罪悪	ざいあく	名	罪恶
再会	さいかい	名，サ変	再会
災害	さいがい	名	灾害
再起	さいき	名，サ変	重新出台；恢复、振作
最近	さいきん	名	最近
細工	さいく	名，サ変	工艺、手工艺品；弄虚作假、做了手脚的
採決	さいけつ	名，サ変	表决
歳月	さいげつ	名	岁月
債券	さいけん	名	债券
再建	さいけん	名，サ変	重建、改造
最後	さいご	名	最后；一旦……就
最期	さいご	名	临死、临终
在庫	ざいこ	名	库存
最高	さいこう	名，形動	最高的；最好的、最了不起的
再三	さいさん	副	再三、多次
採算	さいさん	名	核算、核对
財産	ざいさん	名	财产
際して	さいして	連語	适值……之际
最終	さいしゅう	名	最终
採集	さいしゅう	名，サ変	采集
最初	さいしょ	名	最初
最小	さいしょう	名	最小
最少	さいしょう	名	最少
最上	さいじょう	名	最高；最好
最新	さいしん	名	最新
細心	さいしん	名，形動	细心、周密
再生	さいせい	名，サ変	起死回生；废品的再利用；录音等的播放
財政	ざいせい	名	财政；家庭经济情况、家计
最善	さいぜん	名	最好的；全力
最先端	さいせんたん	名	最先进
催促	さいそく	名，サ変	催促
最大	さいだい	名	最大
最短	さいたん	名	最短
財団	ざいだん	名	财团
最中	さいちゅう	名	最盛的时候；正在进行
最長	さいちょう	名	时期最长、最久
最低	さいてい	名	最低；砸锅、不行、糟糕
採点	さいてん	名，サ変	打分
苛む	さいなむ	他五	虐待、责备
災難	さいなん	名	灾难、不幸、出乎意料的事件
在任	ざいにん	名，サ変	在任、在职、在岗
才能	さいのう	名	才能
采配	さいはい	名	指挥
栽培	さいばい	名，サ変	栽培
再発	さいはつ	名，サ変	复发
裁判	さいばん	名，サ変	审判、裁断
財布	さいふ	名	钱包
細胞	さいぼう	名	生物的细胞；活动的最小单位
催眠	さいみん	名	催眠
材木	ざいもく	名	木材
採用	さいよう	名，サ変	采用；录用
最良	さいりょう	形動	最好的、最完善的
材料	ざいりょう	名	原料；资料、题材；影响行情的原因
幸い	さいわい	名，形動，サ変	幸福、荣幸；核实、方便
遮る	さえぎる	他五	遮挡；阻挡
囀る	さえずる	自五	鸣叫；讲个不停
冴える	さえる	自下一	（光、色、音）清晰、明亮；非常冷；引人注目、令人赞叹；反应快、心情爽快
竿，棹	さお	名	竹竿、钓鱼竿、船篙
坂	さか	名	斜坡；年龄、气势的高低
境	さかい	名	国境、省界；界线、分水岭
栄える	さかえる	自下一	繁荣
逆さ	さかさ	名	相反、颠倒
探す，捜す	さがす	他五	追踪；物色；寻找
杯,盃	さかずき	名	杯子
魚	さかな	名	鱼
肴	さかな	名	下酒菜、佳肴；饮酒时的助兴
遡る	さかのぼる	自五	逆水行舟；回溯、追溯
逆らう	さからう	自五	逆行；反抗
盛り	さかり	名	最盛时期；壮年、精力充沛的时期
下がる	さがる	自五	下降；向后移、向后退；推移、进展；（阶段、程度、数值等）变低
先	さき	名	尖端、末梢、前头；先、早；将来；以前；事前、事先；目的地；剩余、继续；对象、对方
作業	さぎょう	名，サ変	工作、作业
咲く	さく	自五	开花；说话投机
裂く	さく	自五	撕裂；分散、拆开；腾出时间
策	さく	名	计划、策略
索引	さくいん	名	索引
削減	さくげん	名，サ変	减少
錯誤	さくご	名	错误
昨日	さくじつ	名	昨天
作者	さくしゃ	名	作者
搾取	さくしゅ	名，サ変	榨取
削除	さくじょ	名，サ変	删除
作製	さくせい	名，サ変	制作、制造
作成	さくせい	名，サ変	做成、起草
作戦	さくせん	名	军队的作战；策略
昨年	さくねん	名	去年
作品	さくひん	名	作品
作文	さくぶん	名	作文
作物	さくもつ	名	作物
桜	さくら	名	樱花
探る	さぐる	他五	摸、找；调查；探访风景等
酒	さけ	名	酒
蔑む	さげすむ	他五	蔑视
叫ぶ	さけぶ	自五	大声叫喊；主张
裂ける	さける	自下一	裂开
避ける	さける	他下一	避免、逃避；逃避责任；回避、避开；忌讳
下げる	さげる	他下一	降低；下垂、下挂；收拾、打烊；往后退；取钱；降低（阶段、程度、数值等）
支える	ささえる	他下一	支撑；抵挡、抵御；担负、维持
捧げる	ささげる	他下一	捧起；献给；奉献
細やか	ささやか	形動	细小、细微；一点点；简陋
囁く	ささやく	自他五	小声说话；说悄悄话；传闻、谣传
匙	さじ	名	匙子
差し上げる	さしあげる	他下一	举起、抬起；（敬）给
差し当たり	さしあたり	副	目前、眼下、暂且
座敷	ざしき	名	客厅；宴会的席位；（艺妓等到宴会）表演
差し込む	さしこむ	自他五	插入；光线照射；（胸口、腹部）剧疼
指図	さしず	名，サ変	指示、指使
差し出す	さしだす	他五	拿出、伸出；提交；寄信
差し支える	さしつかえる	自下一	影响、不利于；带来困难、麻烦
差し控える	さしひかえる	自他下一	控制、节制；谢绝；在旁等候
刺す	さす	他五	刺、扎；虫子叮咬
指す	さす	他五	指给人看；叫名字、点名；朝着；以……为目标；下象棋
差す	さす	自他五	倒水；添加；擦、涂；举到头上；插、夹带；撑（船）；劝酒、敬酒；呈现出；涨潮
挿す	さす	他五	插、夹带；插花；移接花木
さすが	さすが	副	到底是、不愧是；但是、不过；就连……也
授ける	さずける	他下一	授予、传授
摩る	さする	他五	摩、摩擦
座席	ざせき	名	座位
挫折	ざせつ	名，サ変	中途失败；干劲、希望受挫
誘う	さそう	他五	邀请；相约；加快、催促；诱惑
沙汰	さた	名	通信；评价；指示、指使；行为、事件
定まる	さだまる	自五	决定；稳定、安定；持续、持久；沉静、平稳
定める	さだめる	他下一	决定目标等；制定、规定；使……安定、稳定；镇压、镇抚
幸	さち	名	美食；幸运、幸福
撮影	さつえい	名，サ変	拍照、拍电影
作家	さっか	名	作家
錯覚	さっかく	名，サ変	错觉、幻觉、妄想；误以为
雑誌	ざっし	名	杂志
察する	さっする	サ変	推测；体谅；想象
早速	さっそく	副	赶紧、赶快、马上
殺到	さっとう	名，サ変	蜂拥而至
雑踏	ざっとう	名，サ変	人潮如流
さっぱり	さっぱり	副	素雅的；爽快的；明朗的；清淡的；彻底；一向、完全、一点都；完全不行
里	さと	名	老家、故乡
聡い	さとい	形	聪明的；敏锐的、敏感的
砂糖	さとう	名	白砂糖
悟る	さとる	自他五	醒悟、觉悟；感觉、认知
宛ら	さながら	副	宛如、好像
裁く	さばく	他五	审判、判决
砂漠	さばく	名	沙漠
捌ける	さばける	自下一	畅销、卖光；开通、通情达理
寂しい	さびしい	形	寂寞、悲哀；寂静；令人不满的、令人遗憾的
座標	ざひょう	名	坐标
錆びる	さびる	自下一	生锈
差別	さべつ	名	歧视
作法	さほう	名	惯例、规矩、方式
様	さま	名，代	敬称；表示敬意、客气的说法；样子、情景
冷ます	さます	他五	弄凉、冷却；降低、减低（热情、兴趣）
覚ます	さます	他五	睡醒；使……醒悟、提醒；酒醒
妨げる	さまたげる	他下一	妨碍、阻止
彷徨う	さまよう	自五	徘徊；流浪
寒い	さむい	形	寒冷；胆怯、心虚；简陋的
侍	さむらい	名	武士；有气魄的男子
冷める	さめる	自下一	变冷、变凉；（感情、兴趣等）减退
覚める	さめる	自下一	酒醒；清醒、醒悟；睡醒
褪める	さめる	自下一	褪色、退色
左右	さゆう	名，サ変	左右；两侧；暧昧、含糊；支配、决定；影响
作用	さよう	名，サ変	作用、影响
左翼	さよく	名	左翅膀；左倾
さよなら	さよなら	感	再见
皿	さら	名，接尾	盘子；碟状物；（数量词）碟、盘
更更	さらさら	副	丝毫（不）
晒す	さらす	他五	晒、晾；漂白；置身险境；暴露、公之于众
更に	さらに	副	进一步；更加；反复、再三；（下接否定形式）一点也
猿	さる	名	猴子
去る	さる	自他五	离去；时间流逝；死去；消失；相隔、相距；过去的；除去、消除；辞职；远离、疏远
然る	さる	連体	某；那样、那种
騒がしい	さわがしい	形	吵闹；不稳定、不安定
騒ぐ	さわぐ	自五	吵闹；慌张；激动；起哄、闹事
ざわめく	ざわめく	自五	嘈杂、吵闹；沙沙作响
爽やか	さわやか	形動	爽快、清爽；（口齿等）清楚、爽利
触る	さわる	自五	轻轻地接触、触摸
障る	さわる	自五	妨碍、有害
さん	さん	接尾	用在人名、职务后表示尊敬
参加	さんか	名，サ変	参加
酸化	さんか	名，サ変	酸化、氧化
三角	さんかく	名	三角
山岳	さんがく	名	山岳
参議院	さんぎいん	名	参议院
産業	さんぎょう	名	产业
残業	ざんぎょう	名，サ変	加班
参考	さんこう	名，サ変	参考
残酷	ざんこく	形動	残酷
産出	さんしゅつ	名，サ変	生产
参照	さんしょう	名，サ変	参照、参考
賛成	さんせい	名，サ変	赞成
酸性	さんせい	名	酸性
山積	さんせき	名，サ変	堆积如山
酸素	さんそ	名	氧、氧气
山頂	さんちょう	名	山顶
賛同	さんどう	名，サ変	赞同
残念	ざんねん	形動	遗憾、可惜
参拝	さんぱい	名，サ変	参拜
賛否	さんぴ	名	赞成与反对
散文	さんぶん	名	散文
散歩	さんぽ	名，サ変	散步
山脈	さんみゃく	名	山脉
氏	し	名	氏、姓氏
詩	し	名	诗、诗歌
試合	しあい	名，サ変	比赛、竞赛
仕上げる	しあげる	他下一	结束、完成
幸せ	しあわせ	形動	幸福；幸运
強いる	しいる	他上一	强迫、迫使
仕入れる	しいれる	他下一	进货；学到、获得
仕打ち	しうち	名	（用于坏的方面）对待、态度
自衛	じえい	名，サ変	自卫
支援	しえん	名，サ変	支援
塩	しお	名	食盐
潮	しお	名	潮、潮汐；海水；好机会
塩辛い	しおからい	形	咸、盐味太重
萎れる	しおれる	自下一	（植物）枯萎、蔫；气馁、泄气
鹿	しか	名	鹿
自我	じが	名	自我
司会	しかい	名，サ変	司仪、主持人
紫外線	しがいせん	名	紫外线
四角	しかく	名	四角
視覚	しかく	名	视觉
資格	しかく	名	资格、地位；身份
私学	しがく	名	私立学校
自覚	じかく	名，サ変	自我意识、觉悟；自己所感觉的
仕掛ける	しかける	他下一	着手；设置、安放；挑衅、引起
然し，併し	しかし	接続	但是
仕方	しかた	名	方法、手段、式样
しかも	しかも	接続	而且；即使……也
叱る	しかる	他五	训斥、告诫
時間	じかん	名	小时；时间、光阴；时刻
式	しき	名	仪式；方式；方程式
四季	しき	名	四季
指揮	しき	名，サ変	（军队等）指挥；乐队的指挥
時期	じき	名	时期；季节
時機	じき	名	时机
色彩	しきさい	名	色彩、色调；倾向
敷地	しきち	名	（建筑用地）土地、用地
式典	しきてん	名	仪式、典礼
支給	しきゅう	名，サ変	支付、发放
至急	しきゅう	副	紧急、赶紧
自給	じきゅう	名，サ変	自给
死去	しきょ	名，サ変	死去、去世；逝世
事業	じぎょう	名	事业；企业、实业
頻りに	しきりに	副	屡次、多次
仕切る	しきる	他五	隔开；结帐、清账
資金	しきん	名	资金
敷く	しく	他五	铺被子等；撒开；敷设；摆上；实施
軸	じく	名	轴心；卷轴、书画；坐标轴；活动的中心
仕草	しぐさ	名	行为、姿势；动作
しくじる	しくじる	他五	搞坏、失败；被解雇
仕組む	しくむ	他五	（情节等的）设计；企图
刺激	しげき	名，サ変	刺激；鼓舞、鼓励；使兴奋
茂る	しげる	自五	繁茂
試験	しけん	名，サ変	考试、试验
資源	しげん	名	资源
事件	じけん	名	事件；（强盗、杀人等）案件
次元	じげん	名	数学中用于表示空间范围的次元、维度；事物的看法、立场
時限	じげん	名	时限、时间限制
自己	じこ	名	自己
事故	じこ	名	事故、不幸的事件
思考	しこう	名，サ変	思考、考虑
嗜好	しこう	名	嗜好、喜好
志向	しこう	名，サ変	志向
施行	しこう	名，サ変	实施；生效
事項	じこう	名	事项
時効	じこう	名	时效
時刻	じこく	名	时刻
地獄	じごく	名	地狱
仕事	しごと	名	工作；职务、业务
仕込む	しこむ	他五	教育、传授；采购、进货
時差	じさ	名	时差；错开时间
自在	じざい	名，形動	自如
自殺	じさつ	名，サ変	自杀
資産	しさん	名	资产
持参	じさん	名，サ変	带来
支持	しじ	名，サ変	支持
指示	しじ	名，サ変	指示、指使
事実	じじつ	名，副	事实上；实际上
支社	ししゃ	名	分公司
死者	ししゃ	名	死者
磁石	じしゃく	名	磁石
自主	じしゅ	名	自主
始終	しじゅう	名，副	自始至终、全部；不断、一直
自粛	じしゅく	名，サ変	自己控制自己、自慎
支出	ししゅつ	名，サ変	支出
辞書	じしょ	名	辞书、词典
史上	しじょう	名	历史上
市場	しじょう	名	市场
事情	じじょう	名	状态、理由
辞職	じしょく	名，サ変	辞职
自身	じしん	名	自身、自己
自信	じしん	名	自信
地震	じしん	名	地震
指数	しすう	名	指数
静か	しずか	形動	安静；平静、安稳；宁静
静まる	しずまる	自五	变安静；宁静
鎮まる	しずまる	自五	气势变弱；（疼痛等）有所缓和
沈む	しずむ	自五	沉没；落山；变低；变得阴郁、忧郁；陷入、沦落
沈める	しずめる	他下一	使……下沉；使……陷入不幸状态
静める	しずめる	他下一	使……安静、宁静；平息；调和
鎮める	しずめる	他下一	减少、缓和痛苦等；镇压
辞する	じする	サ変	辞退、辞职；推辞、拒绝
姿勢	しせい	名	姿势；态度、姿态
自制	じせい	名，サ変	自制
施設	しせつ	名	设备、设施
時節	じせつ	名	季节；时势；时机
視線	しせん	名	视线
自然	しぜん	名，形動	大自然；自然、不做作；当然；自然而然
思想	しそう	名	思想
子息	しそく	名	儿子
時速	じそく	名	时速
持続	じぞく	名，サ変	持续、延续
子孫	しそん	名	子孙
下	した	名	下部、下放；楼下；内侧；年纪小；（程度、地位等）低；刚……之后
舌	した	名	舌头；味觉
次第	しだい	名，接尾	顺序；理由、情况；顺其自然；根据……情况而定；立即、一……就
自体	じたい	名，副	自身；原来、原本
事態	じたい	名	事态、情势、局势
時代	じだい	名	时势；（历史上的）年代；人生的某一时期
慕う	したう	他五	怀念；爱慕；敬慕；追随
下請け	したうけ	名，サ変	承包（人）
従う	したがう	自五	服从；跟随；沿着；随着……
従って	したがって	接続	由于、由此
支度，仕度	したく	名，サ変	准备；装备；打扮、整装
自宅	じたく	名	自己家
親しい	したしい	形	亲密、关系好；熟悉
親しむ	したしむ	自五	亲近、认识；习惯
強か	したたか	副，形動	强烈；很、非常；难对付的
滴る	したたる	自五	滴落
下手	したて	名	比别人差、居于人下；（在相扑比赛中）从下面出击
仕立てる	したてる	他下一	做衣服；预备好；培养；把……当成
質	しち	名	典当品、抵押货
自治	じち	名，サ変	自治
市長	しちょう	名	市长
視聴	しちょう	名，サ変	视听；收听收看
自重	じちょう	名，サ変	自重、自爱；保重
質	しつ	名	素质、气质；物质；品质
実	じつ	名	实体、实际；诚意；真实；成果、成绩
実家	じっか	名	娘家；出生的家
失格	しっかく	名，サ変	不配、不称职
しっかり	しっかり	副，サ変	牢固地；结实；值得信赖的；清醒、不糊涂；认真、扎实；确实、的确；很多、足够
疾患	しっかん	名	疾病
失業	しつぎょう	名，サ変	失业
躾	しつけ	名	教养、管教、训练
仕付ける	しつける	他下一	管教、教育；习惯、惯用
執権	しっけん	名	执政、掌权
実験	じっけん	名，サ変	实验、试验；实际经验
実現	じつげん	名，サ変	实现
しつこい	しつこい	形	（色、香、味等）浓艳、腻人；纠缠不休、爱死抠
執行	しっこう	名，サ変	执行
実行	じっこう	名，サ変	实行、付诸行动
実際	じっさい	名，副	实际；真正地
実施	じっし	名，サ変	实施
実習	じっしゅう	名，サ変	实习
実情	じつじょう	名	实情
実践	じっせん	名，サ変	实践
質素	しっそ	名	素质、才能
実態	じったい	名	实际情况、实情
嫉妬	しっと	名，サ変	嫉妒
湿度	しつど	名	湿度
じっと	じっと	副，サ変	一动不动、安静地；专心致志地；耐心地
しっとり	しっとり	副，サ変	湿润；安详、安静
実に	じつに	副	真的；实在；很、非常
実は	じつは	副	说实话、说真的
失敗	しっぱい	名，サ変	错误、失败
実物	じつぶつ	名	实物、原物
尻尾	しっぽ	名	尾巴；末端、末尾
失望	しつぼう	名，サ変	失望
実務	じつむ	名	具体工作、实际工作
質問	しつもん	名，サ変	质问、提问
実用	じつよう	名	实用
設える	しつらえる	他下一	陈设、装饰
質量	しつりょう	名	物质的量；质和量
実力	じつりょく	名	实力
失礼	しつれい	形動，サ変	失礼、无礼；对不起、劳驾；失陪了
失恋	しつれん	名，サ変	失恋
指定	してい	名，サ変	指定
指摘	してき	名，サ変	指出、指示
支店	してん	名	分店
視点	してん	名	视线所至；观点
辞典	じてん	名	词典
自転車	じてんしゃ	名	自行车
指導	しどう	名，サ変	指导
児童	じどう	名	儿童玩的游戏
自動	じどう	名	自动
品	しな	名	物品、商品；质量
撓う	しなう	自五	弯曲、曲折
品物	しなもの	名	物品、商品
老舗	しにせ	名	老字号、老店铺
死人	しにん	名	死人
死ぬ	しぬ	自五	死亡；失去生气；闲置着、不起作用
凌ぐ	しのぐ	他五	忍耐；躲避；克服困难；凌驾、胜过
偲ぶ	しのぶ	他五	追忆
柴	しば	名	柴火
支配	しはい	名，サ変	支配；统治；管理；左右、决定
芝居	しばい	名	戏剧；假象、幌子
自白	じはく	名，サ変	坦白、供认、忏悔
自発	じはつ	形動	自发；主动
芝生	しばふ	名	草坪
暫く	しばらく	副	一会儿；暂时、目前；一段时间
縛る	しばる	他五	捆绑；拘束
辞表	じひょう	名	辞职书
痺れる	しびれる	自下一	麻痹、发麻；陶醉
渋い	しぶい	形	（味道）苦涩；（表情等）苦涩；古朴的、高雅的；小气的
事物	じぶつ	名	事物
自分	じぶん	名	自身、自己；我
紙幣	しへい	名	纸币
四方	しほう	名	四方
志望	しぼう	名，サ変	愿望、志愿
脂肪	しぼう	名	脂肪
死亡	しぼう	名，サ変	死亡
萎む	しぼむ	自五	（气势）衰弱、萎缩
凋む	しぼむ	自五	凋谢
絞る，搾る	しぼる	他五	挤、榨；扎起来；缩小；把声音调小；缩小范围；绞尽脑汁；严厉责备、批评
資本	しほん	名	资本、资金
島	しま	名	岛屿
仕舞う	しまう	自他五	收拾、整理；保存；关门、倒闭
了う	しまう	補助	表示完了；表示不希望出现的结果
始末	しまつ	名，サ変	处理；事态的顺序、前后；不良结果；节约
閉まる	しまる	自五	关门
締まる	しまる	自五	不宽松、紧
自慢	じまん	名，サ変	骄傲、自豪、豪言
地味	じみ	形動	简朴；朴素；老实、内向
染み込む	しみこむ	自五	渗、漏；刻骨铭心；想法、习惯；根深蒂固
地道	じみち	形動	踏实、稳重
染みる	しみる	自上一	渗透；刺痛；感受深；受影响、染上
じみる	じみる	造語	染上、沾上；似乎、仿佛
市民	しみん	名	市民；公民
事務	じむ	名	事务
使命	しめい	名	使命；天职
指名	しめい	名，サ変	（作为候补）推荐、指定；叫名、点名
締めきり	しめきり	名	最终期限
じめじめ	じめじめ	副，サ変	湿润；忧郁
示す	しめす	他五	出示；表达心情等；指点；钟表等显示刻度
閉める	しめる	他下一	关闭；倒闭
締める，絞める	しめる	他下一	系；掐、勒；节约
占める	しめる	他下一	占有；取得、获得
湿る	しめる	自五	湿；气氛阴郁
下	しも	名	下方；下半部分、后半；地位低；离中心远；大小便
霜	しも	名	霜；白发
地元	じもと	名	本地、当地
視野	しや	名	视野；眼界、眼光
釈迦	しゃか	名	释迦牟尼
社会	しゃかい	名	社会；相同行业
蹲む	しゃがむ	自五	蹲下
弱点	じゃくてん	名	弱点、缺点
釈放	しゃくほう	名，サ変	释放
釈明	しゃくめい	名，サ変	阐明、解释、辩解
社交	しゃこう	名	社交
謝罪	しゃざい	名，サ変	谢罪
写実	しゃじつ	名	写实
写真	しゃしん	名	照片
写生	しゃせい	名，サ変	写生
謝絶	しゃぜつ	名，サ変	谢绝、拒绝
社長	しゃちょう	名	社长、总经理
若干	じゃっかん	名，副	若干、多少
借金	しゃっきん	名，サ変	借钱、所借的钱
喋る	しゃべる	他五	聊天、唠叨
邪魔	じゃま	名，サ変	障碍物、妨碍；拜访、串门
三味線	しゃみせん	名	日本的三弦琴
洒落	しゃれ	名	玩笑、风趣话
洒落る	しゃれる	自下一	潇洒；说风趣话
私有	しゆう	名	私有
雌雄	しゆう	名	雌雄；胜负
週	しゅう	名	周、星期
自由	じゆう	名，形動	自由、随便
周囲	しゅうい	名	周围；环境；周围的人
縦横	じゅうおう	名	纵横；自由自在
集会	しゅうかい	名，サ変	集会
収穫	しゅうかく	名，サ変	农作物等的收获；好的结果
就学	しゅうがく	名，サ変	就学、上学
週刊	しゅうかん	名	周刊
習慣	しゅうかん	名	习惯；风习
周期	しゅうき	名	周期
祝儀	しゅうぎ	名	祝贺的仪式
宗教	しゅうきょう	名	宗教
就業	しゅうぎょう	名	就职、工作
修業	しゅうぎょう	None	学习、休业
集計	しゅうけい	名，サ変	统计
集合	しゅうごう	名，サ変	集合
秀才	しゅうさい	名	学识、才能非常优秀的人
終始	しゅうし	副，サ変	始终；一直
修士	しゅうし	名	硕士；修士
収支	しゅうし	名	收支
終止	しゅうし	名，サ変	终止、结束
重視	じゅうし	名，サ変	重视
従事	じゅうじ	名，サ変	从事
十字架	じゅうじか	名	十字架
充実	じゅうじつ	名，サ変	充实
収拾	しゅうしゅう	名，サ変	收拾
収集	しゅうしゅう	名，サ変	收集；收藏、收藏品
従順	じゅうじゅん	形動	温顺、顺从
住所	じゅうしょ	名	住所、住址
就職	しゅうしょく	名，サ変	就职、就业
修飾	しゅうしょく	名，サ変	修饰；修辞
重心	じゅうしん	名	重心；平衡
修正	しゅうせい	名，サ変	修正、改正
習性	しゅうせい	名	习性、习惯
渋滞	じゅうたい	名	进展不顺利、停滞；堵车、道路拥挤
重大	じゅうだい	形動	重大、严重
住宅	じゅうたく	名	住宅
集団	しゅうだん	名	集团、集体
周知	しゅうち	名	众所周知
執着	しゅうちゃく	名，サ変	执著；固执
集中	しゅうちゅう	名，サ変	集中
重点	じゅうてん	名	重点
舅	しゅうと	None	公公；岳父
姑	しゅうと	None	婆母；岳母
習得	しゅうとく	名，サ変	学到知识、掌握技术
修得	しゅうとく	名，サ変	学会、掌握
柔軟	じゅうなん	形動	柔软；有灵活性
収入	しゅうにゅう	名	所得；收益
執念	しゅうねん	名	热情或执著的念头
秋分	しゅうぶん	名	秋分
十分	じゅうぶん	形動，副	许多；完全地
住民	じゅうみん	名	住户、居民
重役	じゅうやく	名	重要职务；董事
重要	じゅうよう	形動	重要
従来	じゅうらい	名	素来、一向
修理	しゅうり	名，サ変	修缮、修理
終了	しゅうりょう	名，サ変	终了、结束
重量	じゅうりょう	名	重量
重力	じゅうりょく	名	重力
収賄	しゅうわい	名，サ変	受贿
主観	しゅかん	名	主观
主義	しゅぎ	名	主义、主张、方针
修業	しゅぎょう	名，サ変	学习知识、技术、手艺
儒教	じゅきょう	名	儒教
授業	じゅぎょう	名，サ変	传授知识、技术、手艺
塾	じゅく	名	私塾
祝賀	しゅくが	名，サ変	祝贺、庆贺
熟語	じゅくご	名	熟语、成语；复合词
祝日	しゅくじつ	名	政府所规定的节假日
縮小	しゅくしょう	名，サ変	缩小、缩减
熟す	じゅくす	自五	果实、葡萄酒等成熟；时机成熟；娴熟、得心应手
宿題	しゅくだい	名	作业；研究中的问题
宿泊	しゅくはく	名，サ変	在外面住宿
祝福	しゅくふく	名，サ変	祝福
宿命	しゅくめい	名	宿命
熟慮	じゅくりょ	名，サ変	深思熟虑
熟練	じゅくれん	名，サ変	熟练
主権	しゅけん	名	主权
受験	じゅけん	名，サ変	参加考试
主催	しゅさい	名，サ変	主持、主办（会议或活动）
取材	しゅざい	名，サ変	采访、收集资料
趣旨	しゅし	名	宗旨
主旨	しゅし	名	主旨
種種	しゅじゅ	名，形動	种种、各种各样
手術	しゅじゅつ	名，サ変	手术
首相	しゅしょう	名	首相
主食	しゅしょく	名	主食
主人	しゅじん	名	（妻子向别人称呼自己的）丈夫；自己所效忠的人；（商店等的）经营者、店主；接待者、东道主
受診	じゅしん	名，サ変	接受诊疗
受信	じゅしん	名，サ変	接受信号；收信、收听
主体	しゅたい	名	主要部分；自主
主題	しゅだい	名	主体
手段	しゅだん	名	手段
主張	しゅちょう	名，サ変	主张
術	じゅつ	名	方法、手段；策略、计谋；魔术
出演	しゅつえん	名，サ変	演出、出场
出荷	しゅっか	名，サ変	装运、出货
出火	しゅっか	名，サ変	着火、起火
出勤	しゅっきん	名，サ変	出動、上班
出家	しゅっけ	名，サ変	出家（人）、和尚
出産	しゅっさん	名，サ変	出生、生孩子
出資	しゅっし	名，サ変	出资、投资
出場	しゅつじょう	名，サ変	（比赛、竞赛等的）出场
出身	しゅっしん	名	出生地；母校
出世	しゅっせ	名，サ変	出生；出家；出名、有出息
出生	しゅっせい	名，サ変	出生、诞生
出席	しゅっせき	名，サ変	出席
出張	しゅっちょう	名，サ変	出差
出入	しゅつにゅう	名，サ変	出入、出进
出発	しゅっぱつ	名，サ変	出发
出版	しゅっぱん	名，サ変	出版
出力	しゅつりょく	名，サ変	输出、输出功率；电子计算机输出的计算结果
首都	しゅと	名	首都
主導	しゅどう	名	主导
受動	じゅどう	名	被动
取得	しゅとく	名，サ変	取得
守備	しゅび	名，サ変	守卫、防御；比赛中的防守
首尾	しゅび	名	始终；结果
主賓	しゅひん	名	主宾
主婦	しゅふ	名	家庭主妇
趣味	しゅみ	名	兴趣、爱好；乐趣、喜好
寿命	じゅみょう	名	人的寿命；耐用期限
種目	しゅもく	名	项目
主役	しゅやく	名	主角；担负主要工作的人
主要	しゅよう	形動	主要
受容	じゅよう	名，サ変	接受、采纳
需要	じゅよう	名	需求
主流	しゅりゅう	名	主流、中心势力
主力	しゅりょく	名	中心势力；主要力量
種類	しゅるい	名	种类
手腕	しゅわん	名	手腕、才能、本领
順位	じゅんい	名	顺序、席次、等级
潤滑油	じゅんかつゆ	名	润滑油
瞬間	しゅんかん	名	瞬间
循環	じゅんかん	名，サ変	循环
順序	じゅんじょ	名	顺序、次序；步骤
準じる	じゅんじる	自上一	按照；相对应
純真	じゅんしん	形動	纯真
純粋	じゅんすい	形動	纯粹
順調	じゅんちょう	名，形動	顺利、一帆风顺
順番	じゅんばん	名	顺序；轮班、轮流
準備	じゅんび	名，サ変	准备
使用	しよう	名，サ変	使用
仕様	しよう	名	做法、方法
試用	しよう	名，サ変	试用
私用	しよう	名，サ変	私事、私人使用
上位	じょうい	名	高的地位、序号、位置
上映	じょうえい	名，サ変	上映、播放
上演	じょうえん	名，サ変	上演
消化	しょうか	名，サ変	消化；吸收、消化知识等；完成
消火	しょうか	名，サ変	灭火
昇華	しょうか	名，サ変	固体的气化；升华
生姜	しょうが	名	生姜
紹介	しょうかい	名，サ変	介绍
障害	しょうがい	名	妨碍、难事；身体的残废
生涯	しょうがい	名	生涯、一生
正月	しょうがつ	名	正月
将棋	しょうぎ	名	象棋
定規	じょうぎ	名	尺子；准则
乗客	じょうきゃく	名	乘客
昇給	しょうきゅう	名	加工资
商業	しょうぎょう	名	商业
状況	じょうきょう	名	状况
情況	じょうきょう	名	情况
消極	しょうきょく	名	消极
上下	じょうげ	名，サ変	上下；上行和下行；标东；身份、地位的高低；上卷和下卷
情景	じょうけい	名	情景
衝撃	しょうげき	名	冲击、撞击；刺激、打击
証言	しょうげん	名，サ変	作证、证词
条件	じょうけん	名	条件
証拠	しょうこ	名	证据
正午	しょうご	名	中午
照合	しょうごう	名，サ変	对照、核对
条項	じょうこう	名	条文、条目
詳細	しょうさい	名，形動	详细、详情
賞賛，称賛	しょうさん	名，サ変	称赞、赞扬
障子	しょうじ	名	拉门、纸隔窗
上司	じょうし	名	上司
正直	しょうじき	形動	正直
常識	じょうしき	名	常识
乗車	じょうしゃ	名，サ変	乘车
少女	しょうじょ	名	少女
上昇	じょうしょう	名，サ変	上升
生じる	しょうじる	自上一	产生；发生
乗じる	じょうじる	自上一	乘机、乘势；算乘法
昇進	しょうしん	名，サ変	晋升
小人	しょうじん	名	小人；小孩
精進	しょうじん	名，サ変	（佛）精进修行；吃素、斋戒；专心；洁身慎行
上手	じょうず	名，形動	娴熟；客套
少数	しょうすう	名	少数
情勢	じょうせい	名	状况、事态
定石	じょうせき	名	（围棋的）一定招数；常规做法
小説	しょうせつ	名	小说
尚早	しょうそう	名	时机未到
肖像	しょうぞう	名	肖像
消息	しょうそく	名	消息、联络；信息
招待	しょうたい	名，サ変	招待
正体	しょうたい	名	原形、真面目；身份；清醒的意识
状態	じょうたい	名	状况、状态
承諾	しょうだく	名，サ変	应允、同意
上達	じょうたつ	名，サ変	学习、技能长进、进步
冗談	じょうだん	名	玩笑话
承知	しょうち	名，サ変	知道；同意；许可；原谅
情緒	じょうちょ	名	风趣、情趣；感情
象徴	しょうちょう	名，サ変	象征
商店	しょうてん	名	商店
焦点	しょうてん	名	（镜头的）焦点；（兴趣、关心的）中心
衝動	しょうどう	名	冲动
上等	じょうとう	形動	高级的、精美的
消毒	しょうどく	名，サ変	消毒
衝突	しょうとつ	名，サ変	相撞；冲突
承認	しょうにん	名，サ変	承认、同意
証人	しょうにん	名	证人
商人	しょうにん	名	商人
情熱	じょうねつ	名	热情、激情
少年	しょうねん	名	少年
勝敗	しょうはい	名	胜败
商売	しょうばい	名	生意；职业
蒸発	じょうはつ	名，サ変	蒸发；人或物消失
消費	しょうひ	名，サ変	消费、支出
賞品	しょうひん	名	奖品
商品	しょうひん	名	商品
上品	じょうひん	形動	洗练、优雅、高雅
勝負	しょうぶ	名，サ変	胜败；比赛、竞赛
丈夫	じょうぶ	形動	健康的；结实的
譲歩	じょうほ	名，サ変	让步
消防	しょうぼう	名，サ変	消防
情報	じょうほう	名	情报；信息
賞味	しょうみ	名，サ変	品尝
正味	しょうみ	名	净重；原价、批发价；内容、实质
静脈	じょうみゃく	名	静脉
証明	しょうめい	名，サ変	证明
照明	しょうめい	名，サ変	照明
正面	しょうめん	名	前面；针锋相对
消耗	しょうもう	名，サ変	消耗；消磨体力、精神
条約	じょうやく	名	条约
将来	しょうらい	名	将来
勝利	しょうり	名，サ変	胜利
省略	しょうりゃく	名，サ変	省略
上流	じょうりゅう	名	河流的上游；社会的上层
浄瑠璃	じょうるり	名	净玻璃（日本的一种曲艺）
奨励	しょうれい	名，サ変	奖励
除外	じょがい	名，サ変	除外
書簡	しょかん	名	书信
初期	しょき	名	时代的初始；最初的阶段
暑気	しょき	名	暑气
初級	しょきゅう	名	初级
職員	しょくいん	名	职员，工作人员
職業	しょくぎょう	名	职业
食事	しょくじ	名，サ変	吃饭、饮食、饭菜
織女	しょくじょ	名	织女
食堂	しょくどう	名	食堂
職人	しょくにん	名	手艺人
職場	しょくば	名	工作场所
食品	しょくひん	名	食品
植物	しょくぶつ	名	植物
職務	しょくむ	名	职务；本职工作
食物	しょくもつ	名	食物
食欲	しょくよく	名	食欲
食料	しょくりょう	名	食物
しょげる	しょげる	自下一	泄气、气馁、消沉
助言	じょげん	名，サ変	劝告、建议
所作	しょさ	名	举止、行为
書斎	しょさい	名	书斋、书房
叙述	じょじゅつ	名，サ変	叙述
処女	しょじょ	名	处女；还未被人涉足过的自然的事物；最初
叙情	じょじょう	名，サ変	抒情
徐々に	じょじょに	副	慢慢地、一点点地
初心	しょしん	名	没有经验；初学；初志
所信	しょしん	名	信念
処する	しょする	サ変	处于；处刑；处理
女性	じょせい	名	女性
書籍	しょせき	名	书籍
所詮	しょせん	副	反正、终究、最终
所属	しょぞく	名，サ変	所属
所帯	しょたい	名	家庭、家业
処置	しょち	名，サ変	处理、措施；治疗
食器	しょっき	名	餐具
しょっちゅう	しょっちゅう	副	经常、总是
しょっぱい	しょっぱい	形	咸的；小气的、吝啬的；为难
所得	しょとく	名	所得；收益
処分	しょぶん	名，サ変	处理；处罚；处分
処方	しょほう	名，サ変	处方；处理方法
庶民	しょみん	名	平民
署名	しょめい	名，サ変	署名、签名
除名	じょめい	名，サ変	除名
書物	しょもつ	名	书籍
所有	しょゆう	名，サ変	所有
処理	しょり	名，サ変	处理；化学处理；事件或事务的处理
助力	じょりょく	名，サ変	帮忙、帮助
書類	しょるい	名	资料
白々	しらじら	副	天亮；白的
白々しい	しらじらしい	形	显而易见地、明显地；佯装不知
焦らす	じらす	他五	使……焦急、着急
知らせる	しらせる	他下一	通知、告诉；通报、预报
調べる	しらべる	他下一	调查、研究；查阅（辞书等）；搜索、检查；审讯
尻	しり	名	臀部；后头；末尾；（器物的）底儿
じりじり	じりじり	副，サ変	铃声等；油炸的吱吱音；一步一步地移动；（太阳光）灼热；坐立不安
退く	しりぞく	自五	后退；回避；隐退、辞职；让步
退ける	しりぞける	他下一	避开；赶跑；反驳、拒绝；打倒、使……下台
私立	しりつ	名	私立
自立	じりつ	名，サ変	自立
思慮	しりょ	名	深思熟虑
資料	しりょう	名	资料
汁	しる	名	果汁；草木的汁；菜汤；（占的）便宜、好处
知る	しる	他五	知道；注意到、醒悟；分辨、区分；理解内容；感到；预见、预知；体验；相识；相关、介入、牵涉
印	しるし	名	记号、符号；标志；凭证
記す	しるす	他五	写下；记述；做记号、标记；记住
辞令	じれい	名	任免证书；应对的语言、辞令
知れる	しれる	自下一	被知道；判明、明白
白	しろ	名	白色；洁白（无罪）
城	しろ	名	城堡；自己的世界
白い	しろい	形	白
素人	しろうと	名	外行
白黒	しろくろ	名，サ変	黑白；困惑、翻白眼；是非、曲直
皺	しわ	名	皱纹；布等的褶皱
師走	しわす	名	12月的别称
芯	しん	名	芯、核心
新鋭	しんえい	形動	新锐
進化	しんか	名，サ変	进化
侵害	しんがい	名，サ変	侵害
心外	しんがい	形動	意外、出乎意料
進学	しんがく	名，サ変	升班、升学
人格	じんかく	名	人格
審議	しんぎ	名，サ変	审议
進級	しんきゅう	名	升级、升班
心境	しんきょう	名	心境、心态
進境	しんきょう	名	进步的程度
しんきん	しんきん	名，サ変	亲近、认识；习惯
真空	しんくう	名	真空、空白
神経	しんけい	名	神经；感觉、精神
真剣	しんけん	名，形動	真刀、真剑；认真地、严肃地
人権	じんけん	名	人权
信仰	しんこう	名	信仰
進行	しんこう	名，サ変	前进；进展；病情恶化
振興	しんこう	名，サ変	振兴
新興	しんこう	名	新兴
信号	しんごう	名	信号、红绿灯
人口	じんこう	名	人口、众人之口
人工	じんこう	名	人工
申告	しんこく	名，サ変	申报
深刻	しんこく	形動	深刻的
新婚	しんこん	名	新婚
審査	しんさ	名，サ変	审查
人材	じんざい	名	人才
診察	しんさつ	名，サ変	诊疗、诊断
紳士	しんし	名	绅士、男士
人事	じんじ	名	人事；人所能做的事
新式	しんしき	名	新式
真実	しんじつ	名，形動	真实；真的、的确
信者	しんじゃ	名	信徒；爱好者
神社	じんじゃ	名	神社
真珠	しんじゅ	名	珍珠
人種	じんしゅ	名	人种
心中	しんじゅう	名，サ変	一起自尽；情死
進出	しんしゅつ	名，サ変	进入；扩展势力、进入
尋常	じんじょう	名，形動	寻常、平常
信じる	しんじる	他上一	信仰；相信；信赖
心身	しんしん	名	身心
新人	しんじん	名	新手、新人
神聖	しんせい	名，形動	神圣
申請	しんせい	名，サ変	申请
人生	じんせい	名	人生
親戚	しんせき	名	亲戚
親切	しんせつ	名，形動	体贴、关怀、热情
新鮮	しんせん	形動	新鲜；清新
親善	しんぜん	名	搞好关系、友谊
真相	しんそう	名	真相、真实、事实
心臓	しんぞう	名，形動	心脏；中心部；胆大、厚脸皮
進退	しんたい	名，サ変	进退；举动、行动；去就
診断	しんだん	名，サ変	诊断；分析、判断
身長	しんちょう	名	身高
慎重	しんちょう	形動	慎重
進展	しんてん	名，サ変	进步、发展
震度	しんど	名	震级
進度	しんど	名	进度
浸透	しんとう	名，サ変	渗透；普及
振動	しんどう	名，サ変	振动、摇晃
震動	しんどう	名，サ変	震动、晃动
人道	じんどう	名	人道；人行道
侵入	しんにゅう	名，サ変	侵入、闯入
新年	しんねん	名	新年
信念	しんねん	名	信念
心配	しんぱい	名，形動，サ変	担心；照顾、张罗
審判	しんぱん	名，サ変	审判、判决；体育裁判
神秘	しんぴ	名	神秘
新婦	しんぷ	名	新娘
人物	じんぶつ	名	人；人格、性格；有才能的人
新聞	しんぶん	名	报刊
進歩	しんぽ	名，サ変	进步
辛抱	しんぼう	名，サ変	忍耐、耐性
人望	じんぼう	名	人望、威望
神妙	しんみょう	形動	老实、规矩；值得敬佩
しんみり	しんみり	副，サ変	深刻地；沉思；肃静
深夜	しんや	名	深夜
親友	しんゆう	名	挚友、密友
信用	しんよう	名，サ変	信赖；相信；信誉
信頼	しんらい	名，サ変	信赖
心理	しんり	名	精神活动、心理
真理	しんり	名	真理
侵略	しんりゃく	名，サ変	侵略
尽力	じんりょく	名，サ変	尽力、努力
親類	しんるい	名	亲戚、家族
人類	じんるい	名	人类
進路	しんろ	名	前进方向；人将来的去向
新郎	しんろう	名	新郎
神話	しんわ	名	神话
巣	す	名	巢、窝；贼窝；住处
酢	す	名	醋
素足	すあし	名	赤脚、光脚
水泳	すいえい	名，サ変	游泳
水害	すいがい	名	水害
推敲	すいこう	名，サ変	推敲
遂行	すいこう	名，サ変	完成、执行
随行	ずいこう	名，サ変	随从、同行
吸い込む	すいこむ	他五	吸收
炊事	すいじ	名，サ変	炊事、做饭菜
衰弱	すいじゃく	名，サ変	衰弱
水準	すいじゅん	名	标准、程度
水上	すいじょう	名	水上、水面
水蒸気	すいじょうき	名	水蒸气
推進	すいしん	名，サ変	推进
推薦	すいせん	名，サ変	推荐
推測	すいそく	名，サ変	推测
垂直	すいちょく	名	垂直
吸い付く	すいつく	自五	紧贴、紧咬
推定	すいてい	名，サ変	推定、假定、估计
水道	すいどう	名	自来水设施；海峡；水路
吸い取る	すいとる	他五	吸取、吸吮；榨取
随筆	ずいひつ	名	随笔、漫笔
随分	ずいぶん	副，形動	非常；特别；够呛；冷酷
水平	すいへい	名	水平
睡眠	すいみん	名，サ変	睡眠
水面	すいめん	名	水面
推理	すいり	名，サ変	推理
推量	すいりょう	名，サ変	推测、推论
吸う	すう	他五	呼吸；吸（烟）；吸收
数学	すうがく	名	数学
数字	すうじ	名	数字
図図しい	ずうずうしい	形	厚颜无耻的
崇拝	すうはい	名，サ変	崇拜、崇敬
末	すえ	名	末尾；结果；将来；排行最后；末世；无足轻重之事
据え付ける	すえつける	他下一	安装、设置
据える	すえる	他下一	摆放；稳定下来；安置；让……坐下
素顔	すがお	名	未化妆的脸；本来面目、真相
透かす	すかす	他五	留下缝隙；冲散、减少；透视
清清しい	すがすがしい	形	空气清爽；心情爽快
姿	すがた	名	姿势；外观、打扮；状况、情况；物体的形状；身影、其人
縋る	すがる	自五	扶、撑、缠住；依赖、依靠
好き	すき	形動	喜爱的；任意、随意
透き	すき	名	缝隙；空隙、余地；疏忽、空子
過ぎ去る	すぎさる	自五	离去；光阴流逝
透き通る	すきとおる	自五	透明；清脆
隙間	すきま	名	缝隙；空暇
過ぎる	すぎる	自上一	通过、穿过；超过；经过、经历；结束、过去；过期；过度、过分；胜于
空く	すく	自五	空；闲下来、手空出来
透く	すく	自五	透明；清脆
直ぐ	すぐ	副	马上；不久；（距离）很近；容易、轻易
掬う	すくう	他五	掬起；突然向上拉
救う	すくう	他五	救助；挽救；弥补
少ない	すくない	形	少
ずくめ	ずくめ	接尾	表示颜色一致、完全的意思
優れる	すぐれる	自下一	出色、优秀、卓越
凄い	すごい	形	可怕、吓人；非常、特别；表示惊讶、惊叹的心情
少し	すこし	副	少量、少数；一点点；稍微；一会儿
過ごす	すごす	他五	度过；过分、过度
筋	すじ	名	线、纹；筋、肌肉；条理、道理；血统；素质；有关方面；数细长东西的量词
筋道	すじみち	名	道理、有理；顺序、步骤
素性	すじょう	名	天生的、生来的；身份；经历
濯ぐ	すすぐ	他五	洗涤
漱ぐ	すすぐ	他五	漱口
雪ぐ	すすぐ	他五	雪耻
涼しい	すずしい	形	凉快；清爽、爽快
進む	すすむ	自五	前进；进展；进入；进步；（病情）恶化；愿意、积极；旺盛；钟表快
雀	すずめ	名	麻雀；消息通
進める	すすめる	他下一	向前进；进展；晋升；增加（食欲）；把时间调快；提高程度
勧める	すすめる	他下一	建议；劝、劝诱
薦める	すすめる	他下一	推荐、推举
硯	すずり	名	砚、砚台
裾	すそ	名	衣摆、下襟；山脚
廃れる	すたれる	自下一	过时、不流行；衰弱、衰落
すっかり	すっかり	副	全部、完全；非常
すっきり	すっきり	副	心情爽快；整洁、清爽；明了
ずっと	ずっと	副	时间、距离相隔阂；一直、不停地；笔直；……得多
酸っぱい	すっぱい	形	酸
すっぽり	すっぽり	副	全盘、整个；刚好
鼈	すっぽん	名	甲鱼
既に	すでに	副	已经、业已
捨てる	すてる	他下一	扔掉；放弃；抛弃、遗弃
砂	すな	名	沙子
素直	すなお	形動	正直、诚实；坦率
即ち	すなわち	接続	即、也就是说
脛	すね	名	小腿
拗ねる	すねる	自下一	执拗、闹别扭
頭脳	ずのう	名	脑；智力
素早い	すばやい	形	行动快、反应迅速
素晴らしい	すばらしい	形	出色；非常、特别
全て	すべて	副	全部
滑る	すべる	自五	下滑；滑溜；打滑；考试落第；地位下降；说溜嘴
窄む	すぼむ	自五	变细、变窄；萎缩
住まう	すまう	自五	居住
済ます	すます	他五	结束；偿还；对付、将就；解决
澄ます	すます	他五	澄清；装模作样、满不在乎；集中注意力
隅	すみ	名	角落
速やか	すみやか	形動	快速、迅速
住む	すむ	自五	居住
済む	すむ	自五	结束；足够、可以；解决
澄む	すむ	自五	清澈；天空无云；声音清亮；没有邪念
相撲	すもう	名	相扑
する	する	サ変	做、干；表示人的感觉；表示某种状态；处于某种状态；值（多少钱）、要；戴、佩
擦る，磨る，擂る	する	他五	擦；用光
刷る	する	他五	印刷
掏る	する	他五	扒窃
狡い	ずるい	形	狡猾、滑头、奸诈
鋭い	するどい	形	锋利的；尖锐的；敏捷的
すれ違う	すれちがう	自五	走岔开、走两岔；一出一进、一来一去；不同、不相符
摩れる，擦れる	すれる	自下一	摩擦；磨破皮；世故、滑头
ずれる	ずれる	自下一	移动、错位；背离、偏离
座る，坐る	すわる	自五	坐；就任
寸法	すんぽう	名	尺寸、尺码；打算、计划
すんなり	すんなり	副，サ変	苗条；痛快、顺利
背	せ	名	脊背；后方；身高
所為	せい	名	原因、缘故
誠意	せいい	名	诚意
生育	せいいく	名，サ変	成长、发育
声援	せいえん	名，サ変	声援、支持、助威
西欧	せいおう	名	西欧
成果	せいか	名	成果
正解	せいかい	名，サ変	正确答案；正确的解释
政界	せいかい	名	政界
性格	せいかく	名	性格；性质
正確	せいかく	形動	正确
生活	せいかつ	名，サ変	生活；生计
正規	せいき	名	正规
世紀	せいき	名	世纪、时代
生気	せいき	名	生气、朝气
正義	せいぎ	名	正义
請求	せいきゅう	名，サ変	要求、索取
盛況	せいきょう	名	盛况
税金	ぜいきん	名	税金
生計	せいけい	名	生计
清潔	せいけつ	形動	清洁、卫生；廉洁
政権	せいけん	名	政治权力；政府
制限	せいげん	名，サ変	限制
成功	せいこう	名，サ変	成功；事业有成
精巧	せいこう	名，形動	精巧、精细
正座	せいざ	名，サ変	正坐、端坐
精彩	せいさい	名	精彩
制裁	せいさい	名，サ変	制裁
製作，制作	せいさく	名，サ変	制造、生产；创作（艺术作品）
政策	せいさく	名	政策
生産	せいさん	名，サ変	生产
清算	せいさん	名，サ変	结帐；清理；赔偿；结束、了结；断绝关系
精算	せいさん	名，サ変	精算、细算
静止	せいし	名，サ変	静止、停止
生死	せいし	名	生死
制止	せいし	名，サ変	制止
政治	せいじ	名	政治
正式	せいしき	名，形動	正式
性質	せいしつ	名	天性、本性；特性
誠実	せいじつ	名，形動	诚实、正直
成熟	せいじゅく	名，サ変	（果物、谷物等）成熟；发育、成熟；时机成熟
青春	せいしゅん	名	青春
清書	せいしょ	名，サ変	誊写、抄写
正常	せいじょう	名，形動	正常
青少年	せいしょうねん	名	青少年
生殖	せいしょく	名，サ変	生殖
精神	せいしん	名	精神、意志
成人	せいじん	名，サ変	成人
制する	せいする	サ変	制止、抑制；控制
精精	せいぜい	副	最多、充其量；尽量
成績	せいせき	名	成绩；工作的成果
清掃	せいそう	名，サ変	清扫
盛装	せいそう	名，サ変	盛装
製造	せいぞう	名，サ変	制造
生存	せいぞん	名，サ変	生存；活下来
生態	せいたい	名	生态；生活状态
盛大	せいだい	形動	盛大
贅沢	ぜいたく	形動，名	豪华；浪费；过度
成長	せいちょう	名，サ変	成长；成熟；发展
晴天	せいてん	名	晴天
生徒	せいと	名	中学生、高中生
制度	せいど	名	制度
正当	せいとう	名，形動	公正；妥当、当然
政党	せいとう	名	政党
青年	せいねん	名	青年
性能	せいのう	名	功能、性能
整備	せいび	名，サ変	配备；维护；检查、维修
製品	せいひん	名	产品
政府	せいふ	名	政府、内阁
制服	せいふく	名	制服
征服	せいふく	名，サ変	征服；克服
生物	せいぶつ	名	生物
成分	せいぶん	名	成分
精密	せいみつ	名，サ変	精密、精细
生命	せいめい	名	生命、寿命；在某一领域的活动；精华、精髓
制約	せいやく	名，サ変	限制、制约；必要条件
静養	せいよう	名，サ変	静养、修养
西洋	せいよう	名	西洋、西方
整理	せいり	名，サ変	整理、整顿；裁减、缩减；偿还
成立	せいりつ	名，サ変	成立；通过议案；实现
勢力	せいりょく	名	势力、影响力
正論	せいろん	名	正确的言论
背負う	せおう	他五	肩、肩负
世界	せかい	名	世界上；生活圈；特定的范围
せかせか	せかせか	副，サ変	急忙、慌慌张张
席	せき	名	座位；地位；集会地点
咳	せき	名	咳嗽
籍	せき	名	户籍；学籍
石炭	せきたん	名	煤炭
責任	せきにん	名	责任；职责
惜別	せきべつ	名	惜别
石油	せきゆ	名	石油
急く	せく	自五	着急、急；急促
世間	せけん	名	人世间；世上的人们；交际、活动的范围
世辞	せじ	名	奉承、讨好
世事	せじ	名	世事、阅历
世相	せそう	名	世态
世帯	せたい	名	家庭
世代	せだい	名	世代、代、辈；同时代的人
折角	せっかく	副	费周折、好不容易；特意；难得的；尽力
せっかち	せっかち	形動	急躁、性急
積極	せっきょく	名	积极
接近	せっきん	名，サ変	接近
設計	せっけい	名，サ変	设计；规划
絶好	ぜっこう	名	最好、特好
絶交	ぜっこう	名，サ変	绝交
切実	せつじつ	形動	切实、迫切
摂取	せっしゅ	名，サ変	摄取、吸收
折衝	せっしょう	名，サ変	谈判
接触	せっしょく	名，サ変	接触；来往、交往、交际
接する	せっする	サ変	接壤；交汇；接近；接触；应对、接待
接続	せつぞく	名，サ変	结合、连结；衔接
絶対	ぜったい	名，副	绝对；决（不、没有）
設置	せっち	名，サ変	设置、开设、设立；配置
設定	せってい	名，サ変	设定、制定
説得	せっとく	名，サ変	说服
切ない	せつない	形	苦恼、难过、痛苦
切迫	せっぱく	名，サ変	紧迫、吃紧；迫近、逼近
設備	せつび	名，サ変	设备
絶望	ぜつぼう	名，サ変	绝望
説明	せつめい	名，サ変	说明
節約	せつやく	名，サ変	节约、节省
設立	せつりつ	名，サ変	设立、开设、成立
瀬戸際	せとぎわ	名	关键时刻、紧要关头
背中	せなか	名	背、背面
是非	ぜひ	名，副	是非、善恶；一定、必定、肯定
狭い	せまい	形	空间狭小、幅度狭窄；（看法、观点）贫乏
迫る	せまる	自五	距离迫近；时间临近、逼近；急迫、急促；强迫、迫使
せめて	せめて	副	至少、哪怕是……也好
攻める	せめる	他下一	攻击、进攻、攻打
責める	せめる	他下一	非难、指责；严厉地要求
台詞	せりふ	名	台词；论调、辩解
世話	せわ	名，サ変	照看、照顾；棘手、麻烦；介绍、斡旋
線	せん	名	线；铁路线；电线、电话线；方针
栓	せん	名	拴、盖、水龙头等
繊維	せんい	名	纤维
前衛	ぜんえい	名	先锋；前锋；前卫
全快	ぜんかい	名	痊愈
選挙	せんきょ	名，サ変	选举
占拠	せんきょ	名，サ変	占据、占有
先月	せんげつ	名	上个月
宣言	せんげん	名，サ変	宣言；宣告、宣称
戦後	せんご	名	第二次大战以后、战后
前後	ぜんご	名，サ変	前面和后面；时间的先后；（顺序）颠倒；大约、左右
先行	せんこう	名，サ変	先行、先走；已有的
専攻	せんこう	名，サ変	专业
選考	せんこう	名，サ変	选拔人才
宣告	せんこく	名，サ変	宣告；体育比赛的判定
全国	ぜんこく	名	全国
潜在	せんざい	名，サ変	潜在、潜伏
洗剤	せんざい	名	洗涤剂
先日	せんじつ	名	上次、前几天
選手	せんしゅ	名	选手
先週	せんしゅう	名	上周
選出	せんしゅつ	名，サ変	选出
戦術	せんじゅつ	名	战术
善処	ぜんしょ	名，サ変	妥善处理
煎じる	せんじる	他下一	煎、熬
先進	せんしん	名	先进
前進	ぜんしん	名，サ変	前进；进展
先生	せんせい	名	老师；对医生、律师、政治家的敬称
全盛	ぜんせい	名	全盛
全然	ぜんぜん	副	一点也不
先祖	せんぞ	名	祖先
戦争	せんそう	名	战争
喘息	ぜんそく	名	哮喘、喘息
全体	ぜんたい	名，副	全体；到底、究竟；本来
選択	せんたく	名，サ変	选择；选拔
洗濯	せんたく	名，サ変	洗涤
先端	せんたん	名	顶尖；最前列
前提	ぜんてい	名	前提
宣伝	せんでん	名，サ変	宣传；吹嘘、鼓吹
前途	ぜんと	名	前途；前面的路
先頭	せんとう	名	开始、先端
銭湯	せんとう	名	澡堂
戦闘	せんとう	名，サ変	战斗
専念	せんねん	名，サ変	专心致志；一心期盼
先輩	せんぱい	名	先辈、前辈、老资格；先入学或毕业的人、先参加工作的人
船舶	せんぱく	名	船舶
選抜	せんばつ	名，サ変	选拔
前半	ぜんはん	名	前半
全部	ぜんぶ	名	全部、整体上
選別	せんべつ	名，サ変	选择、挑选
全滅	ぜんめつ	名，サ変	全灭、全毁、全死
専門	せんもん	名	专业、专长、研究方向；专营、专卖
戦略	せんりゃく	名	战略
占領	せんりょう	名，サ変	占领、占据；垄断、霸占
善良	ぜんりょう	名	善良
全力	ぜんりょく	名	全力
洗練	せんれん	名，サ変	高雅、有教养的；精练
線路	せんろ	名	线路；轨道
粗悪	そあく	形動	简陋的
添う	そう	自五	陪伴；结为夫妇；吻合、能实现
沿う	そう	自五	沿着；遵照、按照
象	ぞう	名	大象
相違	そうい	名，サ変	不同、差异
相応	そうおう	名，形動，サ変	适合、相称
騒音	そうおん	名	嗓音
増加	ぞうか	名，サ変	增加
総会	そうかい	名	全体大会、全会
爽快	そうかい	形動	爽快
総画	そうかく	名	汉字的笔画
総括	そうかつ	名，サ変	总结、汇总
創刊	そうかん	名，サ変	创刊
早急	そうきゅう	名，形動，副	火速、赶快
増強	ぞうきょう	名，サ変	增强、强化
送金	そうきん	名，サ変	汇款
遭遇	そうぐう	名，サ変	遭遇、遇到
総計	そうけい	名，サ変	总计、总共
造詣	ぞうけい	名	造诣
相互	そうご	名，形動	相互
総合	そうごう	名，サ変	综合
相克	そうこく	名，サ変	相克
操作	そうさ	名，サ変	操作机器；运作资金
捜査	そうさ	名，サ変	搜查
創作	そうさく	名，サ変	文学创作；捏造
捜索	そうさく	名，サ変	搜索、搜查
掃除	そうじ	名，サ変	扫除、清扫、打扫
葬式	そうしき	名	葬仪
喪失	そうしつ	名，サ変	丧失
装飾	そうしょく	名，サ変	装饰
騒然	そうぜん	形動	骚然、吵吵闹闹；不稳定、不安定
早々	そうそう	名，副	匆忙；刚……就
創造	そうぞう	名，サ変	创造
想像	そうぞう	名，サ変	想象
相続	そうぞく	名，サ変	继承
早退	そうたい	名，サ変	早退
相談	そうだん	名，サ変	协商、商量
装置	そうち	名，サ変	设备、装备
相当	そうとう	名，サ変，形動，副	相配；相当于；相当程度
騒動	そうどう	名	骚动、暴乱、风潮；争吵、闹事
遭難	そうなん	名，サ変	遇难、遇险
雑煮	ぞうに	名	（日本过新年时吃的）年糕汤
相場	そうば	名	市价、时机；投机；一般的看法
装備	そうび	名，サ変	装备
送別	そうべつ	名，サ変	送别
総理大臣	そうりだいじん	名	首相、总理
創立	そうりつ	名，サ変	创立、筹立
僧侶	そうりょ	名	僧侣
添える	そえる	他下一	添加、补充；附加、附上
疎遠	そえん	名，形動	疏远
疎外	そがい	名，サ変	疏远、冷淡；排挤；异化
俗	ぞく	名，形動	普通、通俗；庸俗、低级；（佛）在家人、俗人
即座	そくざ	名	立即、马上
続出	ぞくしゅつ	名，サ変	连续发生、不断发生
促進	そくしん	名，サ変	促进、助长
属する	ぞくする	サ変	属于、隶属于；所属
属性	ぞくせい	名	属性
即席	そくせき	名	当场、现场；临时凑合
続続	ぞくぞく	副	陆续、纷纷、不断
速達	そくたつ	名，サ変	快件、快递
速度	そくど	名	速度
束縛	そくばく	名，サ変	抑制、束缚；限制、拘束
側面	そくめん	名	侧面；旁边、侧翼；方面；间接地
底	そこ	名	底部、底下；心底、内心；降到最低的物价或行情等
其処	そこ	代	指距对方较近的场所、那里、那儿；那一点
そこで	そこで	接続	于是、因此；那么
損なう	そこなう	他五	伤害、损害；有损于；错过、漏掉；险些
損ねる	そこねる	他下一	伤害、损害
粗雑	そざつ	形動	马虎、粗糙、粗枝大叶
阻止	そし	名，サ変	阻止、妨碍、阻碍
組織	そしき	名，サ変	组织、成立、结成；构成
素質	そしつ	名	素质、才能
そして	そして	接続	然后、于是
謗る，誹る	そしる	他五	诽谤、说人坏话
祖先	そせん	名	祖先
注ぐ	そそぐ	自他五	流入、汇入；落下、降下；浇、洒；灌、注入；灌溉；集中
唆す	そそのかす	他五	挑唆、挑拨、教唆
そそる	そそる	他五	激起、引起
育つ	そだつ	自五	成长、长大、发育；进步、长进
育てる	そだてる	他五	使……成长；促进发育、培养
措置	そち	名	措施、处理
そちら	そちら	代	那边；你；那个；那一位
卒業	そつぎょう	名，サ変	从学校毕业
素っ気無い	そっけない	形	冷淡、冷漠
率直	そっちょく	形動	坦率、直率
そっと	そっと	副	静悄悄地；小心翼翼地；偷偷地；不惊动、不管
卒倒	そっとう	名，サ変	昏倒、晕倒
袖	そで	名	袖子、衣袖；两侧的事物（如飞机的两翼、建筑物的侧厅、边房）
外	そと	名	外面；户外；外边、外面；外部；外表、脸上
備える	そなえる	他下一	准备；备置、备有；具备、具有
備わる	そなわる	自五	备置、备有；具备
其の	その	連体	那、哪个；那时、那件事
そのまま	そのまま	副	原原本本、原封不动的；就那样地；一模一样
側	そば	名	旁边；刚……之后、刚……不久
聳える	そびえる	自下一	高耸、耸立
祖父	そふ	名	祖父、爷爷、外公
祖母	そぼ	名	祖母、奶奶、外婆
素朴	そぼく	形動	朴素、淳朴、简单
粗末	そまつ	名	简陋；不爱惜、不珍惜
染まる	そまる	自五	染上；感染、沾染
背く	そむく	自五	违背、不遵从；违反；辜负
染める	そめる	他下一	染色；映成；着手；留下印象
そよそよ	そよそよ	副，サ変	（风）微微地吹
空	そら	名	天、空中；天气；心情；谎言、假话；背诵
逸らす	そらす	他五	转移、移向；错过、丢掉；岔开、分散
剃る	そる	他五	剃头、刮胡须
反る	そる	自五	翘起来、反翘；身体向后仰
それ	それ	代	那个；那件事；那时
それだけ	それだけ	副	那些、那么多；唯独那个；只有那些、只限于那些
それで	それで	接続	那么；因此；后来
逸れる	それる	自下一	偏离（目标、方向、话题）
揃う	そろう	自五	汇集、聚集；齐全、成套；整齐、一致
揃える	そろえる	他下一	使汇集、使聚集；使齐备、凑齐；摆整齐；使……一致、整齐
そろそろ	そろそろ	副	慢慢地、静悄悄地；渐渐地、一点点地；不久
損害	そんがい	名，サ変	损伤、损害；损失
尊敬	そんけい	名，サ変	尊敬
存在	そんざい	名，サ変	存在
ぞんざい	ぞんざい	形動	粗鲁、草率、不礼貌
損失	そんしつ	名	损失
損じる	そんじる	自上一	损失、损伤
存じる	ぞんじる	自，他上一	“思う、知る”的谦逊语（表示知道；想、认为等意思）
尊重	そんちょう	名，サ変	尊重、重视
損得	そんとく	名	损益、得失、利害
存分	ぞんぶん	副	充分、尽情
田	た	名	水田
他	た	名	其他（人、事、地方）；其他的
体育	たいいく	名	体育
第一	だいいち	名	第一、最初；主要；首先
退院	たいいん	名，サ変	出院
対応	たいおう	名，サ変	相当于、相应的；对付、应对
体温	たいおん	名	体温
退化	たいか	名，サ変	退化
大会	たいかい	名	大会；大型运动会
対外	たいがい	名	对外
大概	たいがい	名，副	大部分；速度；梗概、大概；大体
体格	たいかく	名	体格
大学	だいがく	名	大学
待機	たいき	名，サ変	等待时机、伺机
大気	たいき	名	大气、空气；度量大
大規模	だいきぼ	形動	大规模
代金	だいきん	名	贷款、价款
待遇	たいぐう	名	待遇、报酬、工资；接待、款待
退屈	たいくつ	形動	无聊、厌倦
体系	たいけい	名	体系
対決	たいけつ	名，サ変	决战、交锋
体験	たいけん	名，サ変	体验
太鼓	たいこ	名	鼓
対抗	たいこう	名，サ変	对立；竞争
大根	だいこん	名	萝卜；演技差
滞在	たいざい	名，サ変	停留、逗留；旅居
題材	だいざい	名	题材
対策	たいさく	名	对策、策略
第三者	だいさんしゃ	名	第三者、局外人
大使	たいし	名	大使
退治	たいじ	名，サ変	消灭、扑灭、惩治
大事	だいじ	名，形動	大事；重要、关键；贵重的、珍贵的
大した	たいした	連体	了不起；（下接否定）不算什么、不要紧
体質	たいしつ	名	体质；事物或组织的本质
大衆	たいしゅう	名	大众
体重	たいじゅう	名	体重
対処	たいしょ	名，サ変	处理、应付
対象	たいしょう	名	对象
対照	たいしょう	名，サ変	对比；比较
大正	たいしょう	名	大正
退場	たいじょう	名，サ変	退会、退席、退场
大丈夫	だいじょうぶ	形動	安全、放心；没关系、不要紧
退職	たいしょく	名，サ変	离职、退休
大臣	だいじん	名	大臣、中央政府的部长
対する	たいする	サ変	相对、面对；对于；对抗；对照、与……相比
大勢	たいせい	名	大势；大局
体制	たいせい	名	体制
耐性	たいせい	名	抗药性
態勢	たいせい	名	状态、准备
体積	たいせき	名	体积
大切	たいせつ	形動	重要、贵重；爱惜、珍重
体操	たいそう	名	体操；活动、运动
大体	だいたい	名，副	大体上、大概、概略；基本上、差不多；全部；本来、原来
大胆	だいたん	形動	大胆、有勇气；旁若无人的
大抵	たいてい	副	通常；大概、也许；适度、适当；普通
態度	たいど	名	态度、举止；看法、想法
対等	たいとう	形動	对等、不相上下、平等
台頭	たいとう	名，サ変	抬头、兴起
大統領	だいとうりょう	名	总统
台無し	だいなし	名，形動	告吹、弄坏了
滞納	たいのう	名，サ変	滞纳、拖欠、逾期未缴
退廃	たいはい	名，サ変	颓废、堕落
大半	たいはん	名	大半、大部分
代表	だいひょう	名，サ変	代表；典型的、有代表性的
大分	だいぶ	副	数量多、很、颇、相当地
大部分	だいぶぶん	名	大部分；基本上、差不多
大変	たいへん	形動	够受的、不得了、不简单；重大、严重；非常
逮捕	たいほ	名，サ変	逮捕
待望	たいぼう	名，サ変	盼望已久
台本	だいほん	名	脚本、剧本
怠慢	たいまん	名	怠慢
対面	たいめん	名，サ変	会面、见面
題目	だいもく	名	标题、题目
太陽	たいよう	名	太阳
代用	だいよう	名，サ変	代用、代替
平ら	たいら	形動	平、平坦
代理	だいり	名，サ変	代理（人）
大陸	たいりく	名	大陆
対立	たいりつ	名，サ変	对立
体力	たいりょく	名	体力
対話	たいわ	名，サ変	对话、交换意见
唾液	だえき	名	唾液
絶える	たえる	自下一	结束、中止、停止；消失、灭亡
耐える	たえる	自下一	忍耐、忍受；承受、经得住；值得、堪
倒す	たおす	他五	打倒、推倒；打败；打倒、推翻
倒れる	たおれる	自下一	倒塌；病倒、死；倒台；倒闭、破产
高い	たかい	形	高；在上面、在上空；声音的频率高；工资、费用、价格高；地位高；评价高、声誉高；仪表的刻度高
互いに	たがいに	副	相互、双方
高ぶる	たかぶる	自五	兴奋、紧张；骄傲、自满
高まる	たかまる	自五	变高、提高、高涨；增大、扩大
高める	たかめる	他下一	提高、增高；增加、强化
耕す	たがやす	他五	耕（地）
宝	たから	名	财宝、宝贝
薪	たきぎ	名	木柴
妥協	だきょう	名，サ変	妥协
炊く	たく	他五	煮饭
焚く	たく	他五	烧；熏香
抱く	だく	他五	抱；心怀
沢庵	たくあん	名	萝卜咸菜
類	たぐい	名	同类、种类；（蔑称）之流
沢山	たくさん	副	众多、很多、许多；足够、够了
逞しい	たくましい	形	体格健壮；意志坚定的
巧み	たくみ	形動	巧妙、精巧
企む	たくらむ	他五	打算、企图；预谋
蓄える	たくわえる	他下一	储备、储存；留（胡须、头发）
竹	たけ	名	竹；以松竹梅分等级时的第二
丈	たけ	名	高度；身高；长度；所有、全部
打撃	だげき	名	打击；精神上的打击；损害、损失
妥結	だけつ	名，サ変	妥协
長ける	たける	自下一	擅长
凧	たこ	名	风筝
蛸	たこ	名	章鱼
胼胝	たこ	名	胼胝、老茧
多彩	たさい	形動	丰富多彩的；各种各样的
打算	ださん	名，サ変	打算；算计
確か	たしか	副，形動	确实；可靠的；正常的；大概、或许
確める	たしかめる	他下一	确认、核实
出し抜く	だしぬく	他五	乘机、抢先下手
出し抜け	だしぬけ	形動	出乎意料、突然
多少	たしょう	名，副	多少、多寡；稍微、有点
足す	たす	他五	加上、合计；补充、添足
出す	だす	他五	拿出、取出、送；显现、表现；发出、产生；开始干……
多数	たすう	名	多数
助かる	たすかる	自五	被救、脱险；省钱、省事；有帮助
助ける	たすける	他下一	救助；帮助；促进
尋ねる	たずねる	他下一	寻找、寻求；询问、打听
訪ねる	たずねる	他下一	访问、拜访
ただ	ただ	名	普通的、一般的；不在乎、不计较；免费
ただ	ただ	副，接続	唯、只；仅；但是
只今	ただいま	名，副	现在；刚刚；马上
湛える	たたえる	他下一	装满；洋溢着、呈现出
戦う，闘う	たたかう	自五	打仗、战斗；竞争
叩く	たたく	他五	拍、敲、擂；拍松软；非难、攻击；试探、探问；杀价
正しい	ただしい	形	正确的、对的；正当、正统；端正；正式的
正す	ただす	他五	订正、修正；修改；使……端正；弄清、辨明
佇まい	たたずまい	名	形态、景致；竖立的姿态
佇む	たたずむ	自五	伫立、站立
畳	たたみ	名	榻榻米
畳む	たたむ	他五	折叠；关闭、收拾；藏在心里；杀、干掉
漂う	ただよう	自五	漂流、飘浮；飘香；洋溢、充满
質	たち	名	人的体质、本质；性质
立ち会う	たちあう	自五	到场、在场、会同
立ち上がる	たちあがる	自五	起立；开始、着手；奋起
立ち止る	たちどまる	自五	站住、停步、止步
立場	たちば	名	立场、出境；见地、观点
忽ち	たちまち	副	立刻、马上、一瞬间；突然、忽然
立ち回る	たちまわる	自五	行动、钻营；中途落脚、顺路到
立つ	たつ	自五	竖立；站起来；刺、扎；冒起、升起；门关着；决定、定下；开设；成立；保持、保住；被置于某种立场、状态；传开、散开；离开、出发
絶つ	たつ	他五	断绝；停止、中断；结束
断つ	たつ	他五	剪断、切断；戒、忌；遮断、挡住
建つ	たつ	自五	建起（建筑物）
達者	たっしゃ	名，形動	健壮；熟练、娴熟
達する	たっする	サ変	到达、抵达；达到；精通；实现
脱線	だっせん	名，サ変	脱轨；走题、跑题
脱落	だつらく	名，サ変	脱落、掉；落伍、被淘汰；漏掉
盾	たて	名	盾
縦	たて	名	竖、纵；上下关系
伊達	だて	名，形動	侠气；虚荣、要面子
立て直す	たてなおす	他五	重新竖起；重新调整
建て直す	たてなおす	他五	改建、翻盖；重组、重建
建前	たてまえ	名	主义、方针、原则
建物	たてもの	名	建筑物
立てる，建てる	たてる	他下一	建造；竖立起来；刺、扎；扬起波浪、使冒烟；关闭；设立；决定；让人当；尊敬、给面子；传播、散步；弄出声响
妥当	だとう	形動	妥当
例えば	たとえば	副	例如、比方说
例える，喩える	たとえる	他下一	比喻；举例
たどたどしい	たどたどしい	形	不熟练、没把握
辿る	たどる	他五	沿着前进、边走边找；追寻、探索；寻访
棚	たな	名	架；大陆架
谷	たに	名	山谷
他人	たにん	名	他人
狸	たぬき	名	狸
種	たね	名	种子；血统、种；原因、材料；做菜的材料；戏法、魔术等的招数
楽しい	たのしい	形	快乐、愉快
楽しむ	たのしむ	自他五	享受、欣赏；期待、盼望
頼む	たのむ	他五	享受、欣赏；期待、盼望
束	たば	名	把、困、束
旅	たび	名	旅行、观光
足袋	たび	名	日本式布袜子
度	たび	名	时候；每次……；回、次
度度	たびたび	副	多次、再三
だぶだぶ	だぶだぶ	副，サ変	（衣服等）过于肥大；（人）肥胖；（液体）过多
多分	たぶん	副	也许、或许、可能；许多、很多
食べる	たべる	他下一	吃；生活
多忙	たぼう	名，形動	很忙、非常忙
玉	たま	名	球、硬币
弾	たま	名	子弹、弹子
卵	たまご	名	鸡蛋、鸟蛋等；未出师或未毕业的人、初出茅庐者
魂	たましい	名	灵魂；心、气力、精神
騙す	だます	他五	欺骗；使平静、使平息
たまに	たまに	副	偶尔
偶々	たまたま	副	有时、偶尔；碰巧
賜物	たまもの	名	赐予物、赏赐的物品；……好结果
溜まる	たまる	自五	聚集、汇集；积压、停滞
貯まる	たまる	自五	积攒、积存
堪る	たまる	自五	（后接否定或反语）忍受、受得了
黙る	だまる	自五	沉默、不吱声；不打招呼；不反驳
賜る	たまわる	他五	赏赐、赐予
為	ため	名	有益；因为、为了
駄目	だめ	形動	无用；白费；不可挽救；做不到、不可能；不行
溜息	ためいき	名	叹气、长吁短叹
試す	ためす	他五	试验、尝试、考验
躊躇う	ためらう	自五	踌躇不前、犹豫、迟疑
溜める	ためる	他下一	积蓄、积攒、收集；停滞、累积
多面	ためん	名	多方面
保つ	たもつ	他五	保；维持；保持
袂	たもと	名	和服袖、衣袖；山脚；旁侧
多様	たよう	形動	多种多样的
便り	たより	名	消息、书信
頼る	たよる	他五	投靠；依赖，依靠
堕落	だらく	名，サ変	堕落
だらけ	だらけ	接尾	满是、净是、都是
だらしない	だらしない	形	散漫、马马虎虎；没出息、不争气；不检点、放荡
垂らす	たらす	他五	垂下、披下；流、淌
足りる	たりる	自上一	足够；值得
怠い	だるい	形	倦怠、浑身无力
弛む	たるむ	自五	放松、松开；松懈、松弛
誰	だれ	代	谁
垂れる	たれる	自他下一	悬垂、吊下；垂下；流、淌；施舍
他愛無い	たわいない	形	无聊、不足道；一下子就……、容易；无邪的、天真的
戯れる	たわむれる	自下一	玩弄、玩耍；开玩笑；戏弄、调戏
弾圧	だんあつ	名，サ変	镇压、压制
単位	たんい	名	单位；基本构成因素；学分
短歌	たんか	名	短歌
段階	だんかい	名	等级；阶级、局面
団結	だんけつ	名，サ変	团结
探検	たんけん	名，サ変	探险
単元	たんげん	名	单元
単語	たんご	名	单词、词汇
断固	だんこ	副	果断、坚决
団子	だんご	名	米面作的丸子
男子	だんし	名	男孩；男子
短縮	たんしゅく	名，サ変	缩短、减少
単純	たんじゅん	形動	单纯、简单
短所	たんしょ	名	缺点、弱点
男女	だんじょ	名	男女
誕生	たんじょう	名，サ変	出生、诞生；创设、创办
単身	たんしん	名	单身
箪笥	たんす	名	衣柜、衣橱
淡水	たんすい	名	淡水
男性	だんせい	名	男性
断絶	だんぜつ	名，サ変	结束、消失；断绝
炭素	たんそ	名	碳
短大	たんだい	名	短期大学
団体	だんたい	名	团体、集体；组织
段段	だんだん	副	逐渐地
団地	だんち	名	开发区、住宅小区
単調	たんちょう	形動	单调、平庸
断定	だんてい	名，サ変	断定
端的	たんてき	形動	直截了当地、干脆地；明显地
担当	たんとう	名，サ変	担任、负责
単独	たんどく	名	单独
旦那	だんな	名	主人；丈夫；对男人的称呼
単に	たんい	副	仅仅、只、单
担任	たんにん	名，サ変	担任、负责；班主任
堪能	たんのう	形動，サ変	十分满足；擅长
淡泊	たんぱく	名，形動	清淡；淡泊、坦率
蛋白質	たんぱくしつ	名	蛋白质
担保	たんぽ	名	担保、抵押
段落	だんらく	名	段落；阶段、段落
弾力	だんりょく	名	弹力；柔软性、灵活性
談話	だんわ	名，サ変	谈话、交谈；发表意见、发言
血	ち	名	血液；血脉
治安	ちあん	名	治安
地位	ちい	名	地位
地域	ちいき	名	地域
小さい	ちいさい	形	（体积、面积、身长等）小；（数量、程度）微少、小、低；（年龄）幼小；琐碎、细小；度良小
小さな	ちいさな	連体	小、微小
知恵	ちえ	名	智慧
地下	ちか	名	地下；死后的世界；非法的、秘密的世界
近い	ちかい	形	近、靠近；最近、近日；亲近；亲密；近似于
誓う	ちかう	他五	发誓、宣誓
違う	ちがう	自五	不同、不符合；错误；不正常
近頃	ちかごろ	名	最近
近付く	ちかづく	自五	挨近、靠近；临近；亲近；近似、相似
近道	ちかみち	名	近路；速成法、捷径
力	ちから	名	体力；力、重力、尹力、压力；能力、实力；得力于……；效用、功效；权力、影响力；暴力；魄力；努力；气力、精力；财力、资力
地球	ちきゅう	名	地球
蓄積	ちくせき	名，サ変	积蓄、积累、积攒
地形	ちけい	名	地形
遅刻	ちこく	名，サ変	迟到
知識	ちしき	名	知识
地上	ちじょう	名	地上；人世间
知人	ちじん	名	熟人、相识
地図	ちず	名	地图
知性	ちせい	名	才能、才智、智力、理智
地帯	ちたい	名	地带
父	ちち	名	父亲；创始者
縮まる	ちぢまる	自五	缩小、收缩
縮む	ちぢむ	自五	变短、变小；起皱纹；萎缩
縮める	ちぢめる	他下一	缩小、缩短；裁短、弄小；蜷曲、缩回
地中	ちちゅう	名	地下、地里
秩序	ちつじょ	名	秩序
窒息	ちっそく	名，サ変	窒息
知能	ちのう	名	智力
血の気	ちのけ	名	血色；血气
地方	ちほう	名	地方、地区；地方上、外地
粽	ちまき	名	粽子
巷	ちまた	名	繁华街；人世间
致命	ちめい	名	致命
着実	ちゃくじつ	形動	踏实、牢靠、稳健
着手	ちゃくしゅ	名，サ変	着手、开始
着席	ちゃくせき	名，サ変	坐下
着想	ちゃくそう	名，サ変	立意、构思、主义
茶碗	ちゃわん	名	茶碗、饭碗
注意	ちゅうい	名，サ変	留神、注意；小心、谨慎；忠告、警告
中央	ちゅうおう	名	正中间；中央
中学校	ちゅうがっこう	名	中学
中間	ちゅうかん	名	中间；两者之间；不极端、这种
中継	ちゅうけい	名，サ変	中继、转口、中转；电视或电台转播
中堅	ちゅうけん	名	中坚、骨干
忠告	ちゅうこく	名，サ変	忠告
仲裁	ちゅうさい	名，サ変	仲裁、调解、劝解
中止	ちゅうし	名，サ変	终止、停止
忠実	ちゅうじつ	名，形動	忠实于、忠诚于；如实、照原样
注射	ちゅうしゃ	名，サ変	注射
駐車	ちゅうしゃ	名，サ変	停车
中旬	ちゅうじゅん	名	中旬
抽象	ちゅうしょう	名	抽象
中心	ちゅうしん	名	中央、中心；处于最重要的位置的人或物；焦点、要点
中枢	ちゅうすう	名	中枢
抽選	ちゅうせん	名，サ変	抽签、拈阄
中断	ちゅうだん	名，サ変	中断
躊躇	ちゅうちょ	名，サ変	踌躇、犹豫
中途	ちゅうと	名	半路、中途；半途上
中毒	ちゅうどく	名，サ変	中毒；上瘾
注目	ちゅうもく	名，サ変	注目、注视
注文	ちゅうもん	名，サ変	定做、订货、点菜；要求、条件
中立	ちゅうりつ	名	中立
中流	ちゅうりゅう	名	河中间；中层、中流、中等
中和	ちゅうわ	名，サ変	中和
調印	ちょういん	名，サ変	签字
超越	ちょうえつ	名，サ変	超出；超越
超過	ちょうか	名，サ変	超过
朝刊	ちょうかん	名	朝刊、早报
長期	ちょうき	名	长期
兆候	ちょうこう	名	征兆、兆头、预兆
聴講	ちょうこう	名，サ変	听课、听讲
彫刻	ちょうこく	名，サ変	雕刻
調査	ちょうさ	名，サ変	调查
調子	ちょうし	名	声调；节奏；语调、笔调；做法；情况、样子；气势
徴収	ちょうしゅう	名，サ変	征收
長所	ちょうしょ	名	优点、长处
長女	ちょうじょ	名	长女
嘲笑	ちょうしょう	名，サ変	嘲笑
頂上	ちょうじょう	名	山顶；顶点、极点
調整	ちょうせい	名，サ変	调整
調節	ちょうせつ	名，サ変	调节
挑戦	ちょうせん	名，サ変	挑战
頂戴	ちょうだい	サ変	受到、得到；（带亲昵的口气）请帮我
調達	ちょうたつ	名，サ変	供应、提供；筹备、筹措
調停	ちょうてい	名，サ変	调停、调解
頂点	ちょうてん	名	山顶；顶点、极点
ちょうど	ちょうど	副	正好、恰好；恰巧、碰巧；简直
挑発	ちょうはつ	名，サ変	挑衅
重宝	ちょうほう	形動，サ変	方便、适用；重视、珍惜
調味	ちょうみ	名，サ変	调味
調理	ちょうり	名，サ変	烹调；调理、调治
潮流	ちょうりゅう	名	潮流；趋势
長老	ちょうろう	名	长老
調和	ちょうわ	名，サ変	调和、协调；和谐
貯金	ちょきん	名，サ変	储蓄、存款
直後	ちょくご	名	刚……之后、紧接着；正后面
直接	ちょくせつ	名，副	直接
直線	ちょくせん	名	直线
直前	ちょくぜん	名	即将……之前；正前面
直通	ちょくつう	名，サ変	直通
直面	ちょくめん	名，サ変	面对、面临
著者	ちょしゃ	名	著者、作者
貯蓄	ちょちく	名，サ変	储蓄
直角	ちょっかく	名	直角
直感	ちょっかん	名，サ変	直感、直观
直観	ちょっかん	名，サ変	直观
直径	ちょっけい	名	直径
直行	ちょっこう	名，サ変	直通、直达；正直；率直
ちょっと	ちょっと	副	一会儿、一下；顺便；相当、颇为；喂；一时（难以）、（不大）容易
散らす	ちらす	他五	撒散、吹散；驱散、赶散；分散；消肿
ちらり	ちらり	副	一闪、一晃；稍微、略微
地理	ちり	名	地势、地形、地理；地理情况、路形
塵	ちり	名	灰尘、尘埃；尘世、红尘；少许、一点、丝毫
治療	ちりょう	名，サ変	治疗
散る	ちる	自五	凋谢、落；离散、分散；消散；渗；消肿；涣散、不专心
賃金	ちんぎん	名	工资、薪水
陳情	ちんじょう	名，サ変	陈清
賃貸	ちんたい	名，サ変	出租、出赁
ちんぷんかんぷん	ちんぷんかんぷん	名	莫名其妙、没法理解的（话、事）
沈没	ちんぼつ	名，サ変	沉没；醉倒
沈黙	ちんもく	名，サ変	沉默
陳列	ちんれつ	名，サ変	陈列
つい	つい	副	一不小心、终于；刚刚
追加	ついか	名，サ変	追加、再增加、补上、添补
追求	ついきゅう	名，サ変	追求
追及	ついきゅう	名，サ変	追赶；追问、追究
追究	ついきゅう	名，サ変	探究、深究
追伸	ついしん	名	（信件用于）再者、又启
追跡	ついせき	名，サ変	追踪
一日	ついたち	名	一号、一日
衝立	ついたて	名	屏风
就いて	ついて	接	关于、就
序に	ついでに	副	顺便；就便
追突	ついとつ	名，サ変	（交通工具等）从后面撞上去
遂に	ついに	副	最后、结局、终于
追放	ついほう	名，サ変	驱逐、放逐；开除、革职
費やす	ついやす	他五	耗费、花费；浪费、白费
墜落	ついらく	名，サ変	坠落
通	つう	名，接尾	精于；一封（信）
通貨	つうか	名	通货
通過	つうか	名，サ変	通过、经过；批准
通学	つうがく	名，サ変	上学、走读
通勤	つうきん	名，サ変	上班
通行	つうこう	名，サ変	通行、往来
通じる	つうじる	自他上一	通往、通向；通（电）；领会、理解、沟通；精通、熟悉；行得通；通用；男女私通；包括所有的；以……为媒介
通信	つうしん	名	通信
通俗	つうぞく	名，形動	通俗的、大众化的、平凡的
通知	つうち	名，サ変	通知
通帳	つうちょう	名	折子、凭折
通訳	つうやく	名，サ変	口译
通用	つうよう	名，サ変	通用；行得通
通路	つうろ	名	过道、通道
通話	つうわ	名，サ変	通话
杖	つえ	名	拐杖、手杖
使う	つかう	他五	使用、利用工具；雇佣；使用语言；使用手段；做某事
使える	つかえる	自下一	可以使用、能够适用；有效；能干的；能派上用场的
仕える	つかえる	自下一	侍奉、侍候、服侍
支える	つかえる	自下一	堵、赛；发生障碍；积压、积存；有人使用、没空着
司る，掌る	つかさどる	他五	掌管、控制
尽かす	つかす	他五	用尽、用完
束の間	つかのま	名	一瞬间、转眼间
捕まえる	つかまえる	他下一	逮捕；留住；结成一体
捕まる	つかまる	自五	被逮捕；紧紧抓住；找到、叫到（出租车）
掴む	つかむ	他五	拽住、揪住；抓住、把握住
疲れる	つかれる	自下一	疲劳、劳累；变旧
月	つき	名	月球；月
次	つぎ	名	下次、下回；隔壁、临室
付き合う	つきあう	自五	交际、打交道；陪伴、作陪
突き当たる	つきあたる	自五	冲突、撞上；走到尽头；面临、面对
付き添う	つきそう	自五	陪伴、照料、护理
突き出す	つきだす	他五	推出；伸出、探出；扭送
突き付ける	つきつける	他下一	摆在眼前、亮出；提出
月並み	つきなみ	名	每月、按月；庸俗、老套
月日	つきひ	名	月亮和太阳；日子、岁月、光阴
尽きる	つきる	自上一	用完、用尽；结束
付く	つく	自五	附上、粘附、沾上；留下痕迹；附属、附带；具备、设有；带有；掌握、学会；扎根；跟随、照料；随同、陪伴；偏袒、向着；值、顶、相当于；命名；点火；决定；运气好
突く，衝く	つく	他五	扎、刺、戳；撞、顶；扶、把；严厉地追究；冒着、顶着；扎心、痛心
点く	つく	自五	点（灯）
就く	つく	自五	就、从事；沿着、跟随
着く	つく	自五	到达；触及
搗く	つく	他五	捣
接ぐ	つぐ	自五	连接、嫁接
継ぐ	つぐ	自五	继承；缝补、修缮；添加、续上
机	つくえ	名	书桌
尽くす	つくす	他五	竭尽全力；为……效力、报效、贡献
つくづく	つくづく	副	仔细、细心；深刻地、深切地；实在、切实
償う	つぐなう	他五	赔偿、补偿；弥补
作る	つくる	他五	制作、加工；栽培；耕种；制定；创作；排成、形成；设立；创下纪录等；抽空；交朋友、生孩子；强装、勉强；培养、训练；化妆；做饭菜；报时
造る	つくる	他五	建造；造币；设计庭院；酿造；创造
繕う	つくろう	他五	缝补、修缮；整理、修饰；敷衍
告げ口	つげぐち	名，サ変	告状、告密
漬ける	つける	他下一	浸泡；腌菜
付ける	つける	他下一	靠近、靠紧；贴上、拴上；涂抹；安装；附上、加上；使陪伴、使跟随；留下痕迹；着手、开始做；记录、写；养成、掌握；盛饭等；跟踪、尾随；小心、留意；建立、解决；决定；给予
点ける	つける	他下一	点火（灯）、打开
就ける	つける	他下一	使就座；就职、使从事；使从师
着ける	つける	他下一	佩带、带伤、系上；抵达、到达；把……靠在、贴在
告げる	つげる	他下一	让……听、公布；通知、告知
都合	つごう	名，サ変	方便、合适；情况、关系、理由；准备、安排、抽出；合计、总共
辻	つじ	名	十字路口
伝う	つたう	自五	顺、沿、攀
伝える	つたえる	他下一	通知、传达；传授、继承；从海外引进；传递热、光、声音等
拙い	つたない	形	拙劣、笨拙；不佳
伝わる	つたわる	自五	被传递、被传达；传播、传布；沿着；继承；传来
土	つち	名	土壤、泥土；地面、土地
槌	つち	名	锤子
培う	つちかう	他五	栽培；培养、养成
土臭い	つちくさい	形	土气的
つつく	つつく	他五	轻轻地碰、捅；（用筷子夹着）吃
続く	つづく	自五	继续、持续；连接不断；连接着、挨着；紧接着
続ける	つづける	他下一	继续、持续；连接在一起
突っ込む	つっこむ	自他五	塞入、扔入；突入、突击；钻进、扎进、埋头；追究
謹む，慎む	つつしむ	他五	谨慎、小心；节制、斋戒
突っ張る	つっぱる	自他五	支撑、顶起、撑起；抽筋；猛烈反驳、坚持己见；抵抗、反抗；不良、学坏
慎ましい	つつましい	形	谦虚、谦恭；节约、朴素
鼓	つづみ	名	鼓
包む	つつむ	他五	包装；覆盖、笼罩、沉浸；包红包奉上；隐瞒、藏在心里
綴る	つづる	他五	装订；写作；拼写
都度	つど	名	每次、每回
集い	つどい	名	聚集、集会
勤まる	つとまる	自五	能胜任、干得来
勤める	つとめる	他下一	工作、做事、任职
努める	つとめる	他下一	尽力、努力
綱	つな	名	粗绳、绳索；依靠、命脉
繋がる	つながる	自五	连接；相关、牵涉；有血缘关系；接通电话
繋ぐ	つなぐ	他五	拴、系；结合、牵、拉；维系
津波	つなみ	名	海啸
常	つね	名	平时；常青；普通（人）
常に	つねに	副	时常、总是
抓る	つねる	他五	拧
角	つの	名	牛、羊等动物的角；角状物、触角
募る	つのる	自他五	招募、征集、招聘；增强
唾	つば	名	唾液、唾沫
翼	つばさ	名	翅膀、机翼
燕	つばめ	名	燕子
粒	つぶ	名	颗粒
具に，備に	つぶさに	副	详细、详尽；仔细、认真
潰す	つぶす	他五	弄碎、压碎；宰杀；堵死、赌上；丢脸、损害名誉；消磨时间；败家、使破产；毁坏
呟く	つぶやく	自五	叽咕、唠叨
潰れる	つぶれる	自下一	倒塌、挤坏、压坏；丢人、丢脸；倒闭、破产；坏了、泡汤；痛心、悲痛
坪	つぼ	名	坪（约3.3平方米）
壺	つぼ	名	壶、罐；要点、关键；预料；（针灸的）穴位
窄まる	つぼまる	自五	收缩
蕾む	つぼむ	自五	含苞待放
窄める	つぼめる	他下一	收缩、合上；收拢
妻	つま	名	妻子
爪先	つまさき	名	脚尖
倹しい	つましい	形	节俭、俭朴
躓く	つまずく	自五	绊倒、跌倒、摔跤；失败
詳らか，審らか	つまびらか	形動	详细地、清除地
撮む，抓む，摘まむ	つまむ	他五	摘、掐；下筷子、吃；摘要、摘取
つまらない	つまらない	形	无趣、无聊；不足挂齿
つまり	つまり	副	总之
詰まる	つまる	自五	塞满、挤满；堵塞；困窘、窘迫；收缩
罪	つみ	名	罪孽、罪过；犯罪、罪刑；处罚；罪责
積み替える	つみかえる	他下一	倒装、转运
積み重なる	つみかさなる	自五	堆积；累计、叠加
積み立てる	つみたてる	他下一	储蓄、积攒
積み荷	つみに	名	货物
詰む	つむ	自五	稠密、密实；（下棋时）被将死
積む	つむ	他五	堆积；装运、装载；积累；积蓄、积攒
摘む	つむ	他五	摘取、掐、采
紡ぐ	つむぐ	他五	纺织
瞑る	つむる	他五	闭眼、无视
爪	つめ	名	指甲；（琴）拔子
詰め込む	つめこむ	他五	塞得满满的
冷たい	つめたい	形	寒冷；冷淡、冷漠
詰める	つめる	自他下一	装放、塞入；挤紧、紧靠；憋紧；缩短；节约、节俭；值班、上班；不停地、持续
積もり	つもり	名	意图、打算；期待、预订；就当作……、就算是……
積もる	つもる	自五	积、堆积；累积、积攒
通夜	つや	名	守灵
艶	つや	名	光泽、光亮、润泽；兴趣、妙趣
汁	つゆ	名	汤
露	つゆ	名，副	露水；虚无、短暂；一点也（不）
梅雨	つゆ	名	梅雨、梅雨季节
強い	つよい	形	强、强大；健康、结实；坚强、刚强；对……有抵抗力；棒、过硬；严格、强硬；牢固、紧；擅长、会做；酒量好
強がる	つよがる	自五	逞强、好强
強気	つよき	名	意志坚决、态度强硬；看涨、坚挺
強火	つよび	名	强火
強まる	つよまる	自五	强烈起来、增强
強める	つよめる	他下一	加强、强化、强大
面	つら	名	脸、表面
辛い	つらい	形	难过、难受、难堪；冷酷、刻薄、残酷
連なる	つらなる	自五	成行、成排；列席、参加；参与；牵连
貫く	つらぬく	他五	穿过、穿透、贯通、贯穿；坚持、贯彻
連ねる，列ねる	つらねる	他下一	排成一列；罗列、连接；会同、伴同；带领、率领
釣り合う	つりあう	自五	平衡、均衡；相配、相称；调和
吊り上げる	つりあげる	他下一	吊起；抬高、哄抬
吊革	つりかわ	名	（公交汽车上的）把手、吊环
釣具	つりぐ	名	钓鱼具
釣り銭	つりせん	名	找回的钱、找零
吊る	つる	他五	悬挂、挂；吊起；上吊；向上翘；抽筋
釣る	つる	他五	垂钓；引诱、诱骗
鶴	つる	名	鹤
剣	つるぎ	名	剑
吊るす	つるす	他五	吊起、挂起
連れ	つれ	名	同伴
つれない	つれない	形	冷淡、薄情；不理睬
吊れる	つれる	自下一	吊起来、向上吊
連れる	つれる	他下一	带、领
攣れる	つれる	自下一	抽筋、痉挛
手	て	名	手；把手；动物的前脚；人手；手段、计略、策略；象棋等的走法；笔迹；种类；方向；手艺；所有
出会う	であう	自五	遇见、碰上
手足	てあし	名	手脚；左右手、俯首帖耳的人
出足	であし	名	来的人的多少；起跑、启动；行动开始的情况
手厚い	てあつい	形	热情的、热忱的；丰厚的、优厚的
手当	てあて	名	治疗；津贴、补贴
手編み	てあみ	名	手编、手编织物
手荒い	てあらい	形	粗暴、粗鲁
手洗い	てあらい	名	厕所、卫生间
体	てい	名	（多用于贬义）样子、态度；体面
低	てい	名	低
提案	ていあん	名，サ変	提案、建议
定員	ていいん	名	定额（人员）；规定人数
帝王	ていおう	名	帝王
低下	ていか	名，サ変	降低、下降；减弱、降低
定価	ていか	名	定价、标价
停刊	ていかん	名，サ変	停刊
諦観	ていかん	名，サ変	审视、看破
定期	ていき	名	定期（的月票、存款等）；定期
提起	ていき	名，サ変	提出、提起
定義	ていぎ	名，サ変	定义
低級	ていきゅう	形動	低级
定休	ていきゅう	名	定期休息日、规定休息日
提供	ていきょう	名，サ変	提供
提携	ていけい	名，サ変	协作、合作
締結	ていけつ	名，サ変	缔结
低血圧	ていけつあつ	名	低血压
低減	ていげん	名，サ変	减少、降低；降价
抵抗	ていこう	名，サ変	抵抗；抗拒；反抗；阻力、电阻
定刻	ていこく	名	正点、按时、准时
体裁	ていさい	名	外观；体裁、格式；体面、体统；奉承话、客套话
停止	ていし	名，サ変	停下；中断、停止
提示	ていじ	名，サ変	提示、出示
亭主	ていしゅ	名	老板、店主；丈夫
定住	ていじゅう	名，サ変	定居
貞淑	ていしゅく	名，形動	贞节、贤淑
提出	ていしゅつ	名，サ変	提出、提交
提唱	ていしょう	名，サ変	提倡、倡导
定職	ていしょく	名	固定职业
定食	ていしょく	名	套餐
抵触	ていしょく	サ変	抵触、违反
泥酔	でいすい	サ変	烂醉、醉醺醺
定数	ていすう	名	定数、规定人数
呈する	ていする	サ変	呈送；呈现
訂正	ていせい	名，サ変	订正
定説	ていせつ	名	定论、定说
提訴	ていそ	名，サ変	起诉、提起诉讼
低俗	ていぞく	形動	低俗
手痛い	ていたい	形	重大的、严重的、沉重的
停滞	ていたい	名，サ変	停滞
定着	ていちゃく	名，サ変	扎根、固定、落实
丁重	ていちょう	形動	郑重其事、彬彬有礼
停電	ていでん	名，サ変	停电
程度	ていど	名	程度、水平；标准；限度、范围；大约、大概
丁寧	ていねい	形動	彬彬有礼、恭恭敬敬；详细地、细心地
定年	ていねん	名	退休年龄
低能	ていのう	名	低能
停泊	ていはく	名，サ変	停泊
定番	ていばん	名	常用、常备（的商品）
定評	ていひょう	名	定评、公认
底辺	ていへん	名	最下层、底层
堤防	ていぼう	名	堤防
提要	ていよう	名	提要
低落	ていらく	名，サ変	低落、下降；降低、下落
低利	ていり	名	低利息
定理	ていり	名	定理
出入	でいり	名，サ変	出入、进出；收支、争吵、纠纷；起伏、凹凸
停留	ていりゅう	名，サ変	停留
底流	ていりゅう	名	底流；暗流、潜伏势力
定量	ていりょう	名	定量
手入れ	ていれ	名，サ変	修理、收拾、保养；搜捕、搜查
定例	ていれい	名	常规、惯例；定例
定論	ていろん	名	定论
手掛かり	てがかり	名	线索
出掛ける	でかける	自下一	外出、处罚；访问、串门
出稼ぎ	でかせぎ	名，サ変	外出挣钱、外出干活
手形	てがた	名	手印、掌印；票据（期票、汇票的总称）
手堅い	てがたい	形	坚实的、值得信赖的
手紙	てがみ	名	书信、书筒
手柄	てがら	名	功劳
手軽	てがる	形動	简单、容易
敵	てき	名	敌人、仇敌；竞争对手
出来	でき	名	会；结果；成交；收成
溺愛	できあい	名，サ変	溺爱
出来上がる	できあがる	自五	完成、做完；酒酣、醉意浓
適応	てきおう	名，サ変	适应、适合、符合；顺应
的確	てきかく	形動	正确、确实、准确
適宜	てきぎ	形動，副	适当、适宜；随便、随意
出来具合	できぐあい	名	成绩、结果
出来事	できごと	名	事件、事故
適材	てきざい	名	适当的人才
敵視	てきし	名，サ変	敌视
適時	てきじ	形動	适时
溺死	できし	名，サ変	溺死
摘出	てきしゅつ	名，サ変	摘除、剜掉；指出、暴露
適する	てきする	サ変	适合、适于；配当……、够做……
適正	てきせい	形動	适当、公正
適切	てきせつ	形動	恰当、妥当、确切
敵対	てきたい	名，サ変	敌对、敌视
出来高	できだか	名	产量、工作量；收成、收获量；成交额
的中	てきちゅう	名，サ変	命中、射中；猜中、猜对
適度	てきど	形動	适度
適当	てきとう	形動	合适、恰当；适度、适当；马虎、敷衍
摘発	てきはつ	名，サ変	揭发、检举
出来物	できもの	名	肿物、疙瘩
摘要	てきよう	名	摘要
適用	てきよう	名，サ変	适用
適量	てきりょう	名	适量
出来る	できる	自上一	做好、做完；制作、制造；出产；形成、出现；天生的；设立、成立；可能；好、不错；有修养、人品好；男女搞到一起
適齢	てきれい	名	适龄
手際	てぎわ	名	手腕、手法
手口	てぐち	名	方法、（犯罪）手段
出口	でぐち	名	出口
梃入れ	てこいれ	名	为了打开困难局面而给予援助或支持
てこずる	てこずる	自五	不知所措、棘手
手応え	てごたえ	名	手的感觉；反应、效果
凸凹	でこぼこ	名	凹凸不平；参差不齐；不均衡
手頃	てごろ	形動	正合手；合适、符合
手先	てさき	名	手指尖；爪手、狗腿子
出先	でさき	名	前往的地方；出所
手提	てさげ	名	手提袋、手提包
弟子	でし	名	弟子、徒弟
手品	てじな	名	魔术、戏法
出しゃばる	でしゃばる	自五	多管闲事、插嘴；显耀自己
手順	てじゅん	名	顺序、安排
手数	てすう	名	费事、麻烦、费心
手隙	てすき	名	有空时、闲时
出鱈目	でたらめ	名，形動	荒唐、胡说；胡闹、乱七八糟
手違い	てちがい	名	错误、漏子
手帳	てちょう	名	记事本
鉄	てつ	名	铁；坚定的、坚强的
撤回	てっかい	名，サ変	撤回
哲学	てつがく	名	哲学；想法、观点、主张
手付き	てつき	名	手的姿势、动作
撤去	てっきょ	名，サ変	拆掉、撤去、撤除
鉄筋	てっきん	名	钢筋
手作り	てづくり	名	手工制作、自己做
鉄鉱	てっこう	名	铁矿
鉄鋼	てっこう	名	钢铁
撤する	てっする	サ変	刻骨铭心；彻底、始终；彻夜、通宵
鉄則	てっそく	名	铁的法则、严格的规定
手伝う	てつだう	自他五	帮助；加上
でっち上げる	でっちあげる	他下一	捏造
手続	てつづき	名	手续
徹底	てってい	名，サ変	彻底
鉄道	てつどう	名	铁路
撤廃	てっぱい	名，サ変	撤销、废除
撤兵	てっぺい	名，サ変	撤兵
鉄棒	てつぼう	名	铁棒；单杠
鉄砲	てっぽう	名	来福枪、步枪
徹夜	てつや	名，サ変	彻夜
出所	でどころ	名	出所、出处；出口
手取り	てどり	名	纯收入
出直す	でなおす	自五	再来、重来；重新开始、重新做起
手慣れる	てなれる	自下一	熟练；习惯、使惯
手荷物	てにもつ	名	随身行李
手抜かり	てぬかり	名	疏忽、遗漏、漏洞
手抜き	てぬき	名	偷工（减料）
手拭い	てぬぐい	名	毛巾、手帕
掌，手のひら	てのひら	名	手掌
手配	てはい	名，サ変	安排、筹备；部署、布置
手羽先	てばさき	名	鸡翅膀
手旗	てばた	名	信号旗
手放す	てばなす	他五	放手；放下（工作）；让孩子离开身边
手早い	てばやい	形	敏捷、麻利
手引き	てびき	名	引路、向导；入门书
手拭き	てふき	名	擦手布、擦手纸
手袋	てぶくろ	名	手套
手ぶら	てぶら	名	空手
手振り	てぶり	名	打手势
手弁当	てべんとう	名	自己的盒饭；无报酬、义务
手本	てほん	名	字帖、画帖；模范、榜样
手間	てま	名	所费的时间和劳力
手前	てまえ	名	这边、跟前；鄙人；你这家伙、你；考虑到、顾及体面
手真似	てまね	名	手势、用手比划
手回し	てまわし	名，サ変	用手搅；安排、布置
出回る	でまわる	自五	上市；随处可见、到处是
出店	でみせ	名	分店；摊子
手土産	てみやげ	名	简单礼品
出迎える	でむかえる	他下一	出迎、迎接
出向く	でむく	自五	前往、前去
でも	でも	接続	但是、可是、不过
手持ち	てもち	名	手头的、现有的
手元	てもと	名	手头、手里；手的动作；手头的现象
寺	てら	名	寺庙
衒う	てらう	他五	夸耀、炫耀、显示
照らし合わせる	てらしあわせる	他下一	对照
照らす	てらす	他五	照射、照耀；比较、参观
照り付ける	てりつける	自下一	暴晒
手料理	てりょうり	名	亲手做的菜、家里做的菜
照る	てる	自五	照射、照耀
出る	でる	自下一	外出；迈出；出发、离去；出现；突出、露出；流出；出席；接电话；到达；超过；出版、登载；看到；得到；出现；发生；出产；来自；带来；进入；毕业；支出；销售；采取……态度；增加
照照坊主	てるてるぼうず	名	扫晴娘
照れ臭い	てれくさい	形	害羞
照れる	てれる	自下一	害羞
手練手管	てれんてくだ	名	花招、哄骗
手渡す	てわたす	他五	亲手交给
電圧	でんあつ	名	电压
転移	てんい	名，サ変	转移
天衣無縫	てんいむほう	名，形動	天衣无缝；天真烂漫
店員	てんいん	名	店员
田園	でんえん	名	田地；田园
天下	てんか	名	天下；全国；世上；国家政权；……人的天下
添加	てんか	名，サ変	添加
転化	てんか	名，サ変	转变；转化
転嫁	てんか	名，サ変	转嫁
点火	てんか	名，サ変	点火
殿下	でんか	名	殿下
展開	てんかい	名，サ変	展开；进展；展现
転回	てんかい	名，サ変	旋转；转变
天外	てんがい	名	天外
天涯	てんがい	名	天涯
電解	でんかい	名，サ変	电解
転換	てんかん	名，サ変	转变
癲癇	てんかん	名	癫痫
天気	てんき	名	天气；晴天；心情
転機	てんき	名	转机
伝記	でんき	名	传记
電気	でんき	名	电力；电灯
電球	でんきゅう	名	灯泡
転居	てんきょ	名，サ変	迁居
転勤	てんきん	名，サ変	调动工作
天狗	てんぐ	名	天狗（想象中的妖怪）；自负、得意
天空	てんくう	名	天空
典型	てんけい	名	模范；典型
点検	てんけん	名，サ変	检查
電源	でんげん	名	电源；电力资源
典故	てんこ	名	典故
点呼	てんこ	名，サ変	点名
天候	てんこう	名	天气
転向	てんこう	名，サ変	转变；（特指对共产主义的）背叛
転校	てんこう	名，サ変	转学
電光	でんこう	名	电灯光；闪电；动作极快
篆刻	てんこく	名，サ変	篆刻
天国	てんごく	名	天堂；乐园
伝言	でんごん	名，サ変	传话
天才	てんさい	名	天才
天災	てんさい	名	天灾
点在	てんざい	名，サ変	散布
添削	てんさく	名，サ変	修改
天使	てんし	名	天使
展示	てんじ	名，サ変	展示
電子	でんし	名	电子
電車	でんしゃ	名	电车
店主	てんしゅ	名	店主
天寿	てんじゅ	名	天年、天寿
伝授	でんじゅ	名，サ変	传授
天井	てんじょう	名	天花板；物体内部最高处；（物价、股市的）最高点
添乗	てんじょう	名，サ変	陪同
伝承	でんしょう	名，サ変	代代相传、传说、口传
天職	てんしょく	名	神圣职责、天职；（适合天性的）天职
転職	てんしょく	名，サ変	改行
転じる	てんじる	自他上一	转变、改变
点じる	てんじる	他上一	加批点、标点；画、点；点灯；点；点茶
転身	てんしん	名，サ変	改变、转行
点心	てんしん	名	电信
天真爛漫	てんしんらんまん	名，形動	天真烂漫
点数	てんすう	名	分数、件数
天性	てんせい	名	天性
伝説	でんせつ	名	传说
点線	てんせん	名	虚线
伝染	でんせん	名，サ変	传染
電線	でんせん	名	电线
転送	てんそう	名，サ変	转投、转寄
天体	てんたい	名	天体
電卓	でんたく	名	台式电子计算机
伝達	でんたつ	名，サ変	传达
恬淡	てんたん	名，形動	淡泊
天地	てんち	名	天地；天地；货物的上下面
電池	でんち	名	电池
電柱	でんちゅう	名	电线杆
天敵	てんてき	名	天敌
点滴	てんてき	名	雨点；输液
転転	てんてん	副，サ変	滚转；辗转
店頭	てんとう	名	店头
転倒	てんとう	名，サ変	跌倒；惊慌失措；颠倒
伝統	でんとう	名	传统
電灯	でんとう	名	电灯
電動	でんどう	名	电动
天丼	てんどん	名	炸虾盖浇饭
転入	てんにゅう	名，サ変	迁来、搬来
電熱	でんえつ	名	电热
天然	てんねん	名	天然
天皇	てんのう	名	天皇
伝播	でんぱ	名，サ変	流传；（物）传播
電波	でんぱ	名	电波
天罰	てんばつ	名	天罚
天引き	てんびき	名，サ変	（发放工资之前）预先扣除
伝票	でんぴょう	名	（贸易往来的）票据
添付	てんぷ	名，サ変	附上
転覆	てんぷく	名，サ変	翻倒；推翻、颠覆
天麩羅	てんぷら	名	油炸食品；镀金；假冒
伝聞	でんぶん	名，サ変	传闻
澱粉	でんぷん	名	淀粉
店舗	てんぽ	名	店铺
展望	てんぼう	名，サ変	放眼展望；展望
電報	でんぽう	名	电报
顛末	てんまつ	名	来龙去脉
点滅	てんめつ	名，サ変	忽亮忽灭
天文	てんもん	名	天文
転用	てんよう	名，サ変	挪用
伝来	でんらい	名，サ変	传入；祖传
転落	てんらく	名，サ変	跌落；堕落
展覧	てんらん	名，サ変	展览
電流	でんりゅう	名	电流
電力	でんりょく	名	电力
電路	でんろ	名	电路
電話	でんわ	名，サ変	电话（机）；（打）电话
戸	と	名	门
度	ど	名	程度；度数
問い	とい	名	提问；问题
問い合わせる	といあわせる	他下一	询问
吐息	といき	名	叹气
問う	とう	他五	问；追查；（用否定形式表示）不管
どう	どう	副，サ変	怎么样、怎么、如何
堂	どう	名	佛堂；会堂
同	どう	名	同；表示相同
答案	とうあん	名	答案、答卷
同意	どうい	名，サ変	同意；同义
統一	とういつ	名，サ変	统一
同一	どういつ	名，形動	同一
動員	どういん	名，サ変	动员、发动
動因	どういん	名	动机
投影	とうえい	名，サ変	投影；反映
投下	とうか	名，サ変	投下；投资
どうか	どうか	副	请；好歹会、总会；是否；不正常、可笑
動画	どうが	名	动画
当該	とうがい	连体	该、有关
等外	とうがい	名	等外
導火線	どうかせん	名	导火线；诱因
統轄	とうかつ	名，サ変	统辖
唐辛子	とうがらし	名	辣椒
同感	どうかん	名，サ変	同感
冬季	とうき	名	冬季
冬期	とうき	名	冬季期间
投機	とうき	名，サ変	投机
陶器	とうき	名	陶器
討議	とうぎ	名，サ変	讨论
動機	どうき	名	动机
同期	どうき	名	同时期；同年级
等級	とうきゅう	名	等级
同居	どうきょ	名，サ変	同住
道教	どうきょう	名	道教
当局	とうきょく	名	当局
道具	どうぐ	名	器具；具备的条件；手段、工具
道化	どうけ	名	滑稽
峠	とうげ	名	山顶；极点、顶点
統計	とうけい	名，サ変	统计
陶芸	とうげい	名	陶瓷工艺
凍結	とうけつ	名，サ変	结冰；冻结
洞穴	どうけつ	名	洞穴
登校	とうこう	名，サ変	上学
投稿	とうこう	名，サ変	投稿
投合	とうごう	名，サ変	相投
統合	とうごう	名，サ変	统一、集中
動向	どうこう	名	动向
瞳孔	どうこう	名	瞳孔
同行	どうこう	名，サ変	同行
踏査	とうさ	名，サ変	实地调查、勘查
当座	とうざ	名	当时；眼前；活期存款的略语
動作	どうさ	名	动作
搭載	とうさい	名，サ変	装载
東西	とうざい	名	东西；各个方向；方向
倒錯	とうさく	名，サ変	错乱
盗作	とうさく	名，サ変	剽窃
倒産	とうさん	名，サ変	破产
動産	どうさん	名	动产
凍死	とうし	名，サ変	冻死
投資	とうし	名，サ変	投资
透視	とうし	名，サ変	透视；预测未来
闘志	とうし	名	斗志
当時	とうじ	名	当时
当事	とうじ	名	当事
動詞	どうし	名	动词
同志	どうし	名	同志
同士	どうし	名	同伴、……们、彼此之间
同時	どうじ	名	同时、同时期
陶磁器	とうじき	名	陶瓷器
当日	とうじつ	名	当天、当日
どうして	どうして	副，感	怎样、为什么
如何しても	どうしても	副	务必；怎么也
党首	とうしゅ	名	党的首脑
投手	とうしゅ	名	棒球投手
同種	どうしゅ	名	同一种类（人种）
踏襲	とうしゅう	名，サ変	沿袭
当初	とうしょ	名	当初
投書	とうしょ	名，サ変	投稿、投书
登場	とうじょう	名，サ変	登台；出场
搭乗	とうじょう	名，サ変	搭乘、乘坐
同情	どうじょう	名，サ変	同情
投じる	とうじる	自他上一	投宿；投合；投、跳进；给、配给
投身	とうしん	名，サ変	投河（海）
等身	とうしん	名	等身
統帥	とうすい	名，サ変	统帅
陶酔	とうすい	名，サ変	陶醉
どうせ	どうせ	副	反正
統制	とうせい	名，サ変	统制；管制
動静	どうせい	名	动静
同棲	どうせい	名，サ変	（未正式结婚的男女）同居
当選	とうせん	名，サ変	当选
当然	とうぜん	形動，副	当然
どうぞ	どうぞ	副	设法；请；请吧
逃走	とうそう	名，サ変	逃跑
闘争	とうそう	名	斗争
同窓	どうそう	名	同窗
統率	とうそつ	名，サ変	统帅
淘汰	とうた	名，サ変	淘汰；（自然）淘汰
灯台	とうだい	名	灯塔；烛台
動態	どうたい	名	动态
導体	どうたい	名	导体
胴体	どうたい	名	躯干、船体、机体
到達	とうたつ	名，サ変	到达
統治	とうち	名，サ変	统治
到着	とうちゃく	名，サ変	抵达
盗聴	とうちょう	名，サ変	窃听
当直	とうちょく	名，サ変	值班
到底	とうてい	副	无论如何也、怎么也
童貞	どうてい	名	童贞、处男
道程	どうてい	名	路程
動的	どうてき	形動	活动的、有生气的
貴い	とうとい	形	高贵
尊い	とうとい	形	珍贵、尊贵
滔滔	とうとう	形動	（江水）滔滔；滔滔不绝
とうとう	とうとう	副	终于
堂堂	どうどう	形動，副	堂堂；公然
道徳	どうとく	名	道德
唐突	とうとつ	形動	唐突
尊ぶ	とうとぶ	他五	尊重、尊敬
東南	とうなん	名	东南
盗難	とうなん	名	失盗
どうにも	どうにも	副	的确；无论如何也
投入	とうにゅう	名，サ変	倒入；投放
豆乳	とうにゅう	名	豆浆
導入	どうにゅう	名，サ変	引进；导入（部分）
当人	とうにん	名	本人
党派	とうは	名	党派
同輩	どうはい	名	同等身份的人、伙伴、年龄相仿的人
討伐	とうばつ	名，サ変	讨伐
当番	とうばん	名	值班
逃避	とうひ	名，サ変	逃避
投票	とうひょう	名，サ変	投票
道標	どうひょう	名	路标
豆腐	とうふ	名	豆腐
動物	どうぶつ	名	动物
当分	とうぶん	副	暂时
答弁	とうべん	名，サ変	答辩
東方	とうほう	名	东方
東奔西走	とうほんせいそう	名，サ変	四处奔走
動脈	どうみゃく	名	动脉；（交通）大动脉
冬眠	とうみん	名，サ変	冬眠
透明	とうめい	名，形動	透明
同盟	どうめい	名	同盟
当面	とうめん	名，サ変，副	面临；当前
どうも	どうも	副	怎么也；总觉得；实在；（用来打招呼或表示）感谢、歉意
玉蜀黍	とうもろこし	名	玉米
陶冶	とうや	名，サ変	陶冶
どうやら	どうやら	副	好歹；总觉得
登用	とうよう	名，サ変	任用
東洋	とうよう	名	东洋
盗用	とうよう	名，サ変	窃用
動揺	どうよう	名，サ変	摇晃；精神等动摇
同様	どうよう	形動	一样
童謡	どうよう	名	童谣
到来	とうらい	名，サ変	到来；（他人）送来
道楽	どうらく	名	嗜好、喜好；不务正业
動乱	どうらん	名	动乱、骚乱
道理	どうり	名	道理；理由
道理で	どうりで	副	怪不得
同僚	どうりょう	名	同事
動力	どうりょく	名	动力
答礼	とうれい	名，サ変	还礼
道路	どうろ	名	道路
登録	とうろく	名，サ変	注册
討論	とうろん	名，サ変	讨论
当惑	とうわく	名，サ変	为难
童話	どうわ	名	童话
遠い	とおい	形	（距离）远；（时间）长；关系疏远；迟钝、不敏锐；相差悬殊
十日	とおか	名	十号；十天
遠く	とおく	名	远地
遠ざかる	とおざかる	自五	远离；疏远
通す	とおす	他五	使……通行；领进；使……穿过；使……透过；看完；使……合格；一直；通过；经过；坚持
遠出	とおで	名，サ変	出远门
遠回し	とおまわし	名，形動	委婉（地）
遠回り	とおまわり	名，形動	绕道；麻烦
通り	とおり	名	街道；通行；水、空气的流通；（声音的）响亮；评价、声誉；理解、领会；同样的状态
通る	とおる	自五	通过、穿过；通过（考核、审查）；穿过；闻名
科	とが	名	过错、罪过
都会	とかい	名	都市
度外視	どがいし	名，サ変	置之度外
蜥蜴	とかげ	名	蜥蜴
溶かす，融かす解かす	とかす	他五	溶解、融化
梳かす	とかす	他五	梳
咎める	とがめる	他下一	责备；内疚；盘问
尖る	とがる	自五	尖；（神经）过敏；发怒
時	とき	名	时间；时辰；时候；时代；季节；当时的；好时机；场合
土器	どき	名	瓦奇、陶器
怒気	どき	名	怒气
時折	ときおり	副	偶尔
どきっと	どきっと	副，サ変	大吃一惊
時時	ときどき	副，名	时时；各个时期
どきどき	どきどき	副，サ変	扑通扑通地跳
時に	ときに	副，接続	有时；可是、不过
ときめく	ときめく	自五	心脏（因兴奋而）扑通乱跳
時めく	ときめく	自五	得志、走运
度胸	どきょう	名	胆量
跡切れる	とぎれる	自下一	中断
解く	とく	他五	解开、解除；解答；消除；废除
説く	とく	他五	说明
溶く	とく	他五	溶解、化开
得	とく	名，形動	收益；得好处、方便、合算
研ぐ	とぐ	他五	研磨；擦亮；淘洗
退く	どく	自五	让开、躲开
毒	どく	名	毒药；有毒；毒害；（语言、行动）伤人
得意	とくい	名，形動	得意洋洋；擅长；主顾
特異	とくい	名，形動	特异
独学	どくがく	名，サ変	自学
特技	とくぎ	名	特殊技能
独裁	どくさい	名，サ変	独裁
得策	とくさく	名	上策
特産	とくさん	名	特产
独自	どくじ	名，形動	独自；独特
得失	とくしつ	名	得失
特質	とくしつ	名	特性
読者	どくしゃ	名	读者
特殊	とくしゅ	名，形動	特殊
特集	とくしゅう	名，サ変	专辑、特刊
読書	どくしょ	名，サ変	读书、阅读
涜職	とくしょく	名，サ変	渎职
特色	とくしょく	名	特色
独身	どくしん	名	独身
得する	とくする	サ変	占便宜、赚
毒する	どくする	サ変	毒害
特性	とくせい	名	特性
毒舌	どくぜつ	名	刻薄话、挖苦话
独占	どくせん	名，サ変	独占；垄断
独善	どくぜん	名	自以为是
独創	どくそう	名，サ変	独创
独奏	どくそう	名，サ変	独奏
独走	どくそう	名，サ変	一个人单跑；遥遥领先；单独行动
特種	とくだね	名	特讯、独家新闻
独断	どくだん	名，サ変	独断
特注	とくちゅう	名，サ変	特别订购
特徴	とくちょう	名	特征、特点
特長	とくちょう	名	优点
特定	とくてい	名，サ変	特定
得点	とくてん	名	得分
独特	どくとく	形動	独特
毒毒しい	どくどくしい	形	似乎有毒；恶毒、凶恶；（颜色）刺眼、浓艳
特に	とくに	副	格外、特别
独白	どくはく	名，サ変	独白
特別	とくべつ	副，形動	特别、特殊
読本	とくほん	名	读本、入门书
匿名	とくめい	名	匿名
毒薬	どくやく	名	毒药；有毒；毒害；（语言、行动）伤人
特有	とくゆう	名，形動	特有
独立	どくりつ	名，サ変	独立；单独
髑髏	どくろ	名	骷髅
刺，棘	とげ	名	刺、荆棘；（说话）尖酸、刻薄
時計	とけい	名	钟表
溶け込む	とけこむ	自五	融为一体
刺刺しい	とげとげしい	形	（说话）带刺
解ける	とける	自下一	松了；（怒气）消了；答出、解开；解除（禁令等）
溶ける，融ける	とける	自下一	溶解；溶化
熔ける	とける	自下一	熔化
遂げる	とげる	他下一	达到、完成；最终
退ける	どける	他下一	挪开、移开
土建	どけん	名	土木建筑的略语
床	とこ	名	床铺、被窝；壁龛的略称；河床
何処	どこ	代	哪儿
怒号	どごう	名	怒吼
床の間	とこのま	名	壁龛
床屋	とこや	名	理发店；理发师
所　処	ところ	名	地点；地区；住处；余地；部分；之处；正……的时候；内容、范围
ところが	ところが	接続	然而
所狭し	ところ狭し	連語	满满的
ところで	ところで	接続	（转换话题）可是；哦；对了
所々	ところどころ	名	到处
鶏冠	とさか	名	鸡冠
鎖す，閉ざす	とざす	他五	锁；封锁；封闭
登山	とざん	名，サ変	登山
都市	とし	名	都市
年	とし	名	年；年龄
年上	としうえ	名	年长
年越し	としこし	名	除夕
閉じ込める	とじこめる	他下一	关在里面
閉じ籠る	とじこもる	自五	闷在（家中、屋里）
年頃	としごろ	名，副	妙龄、适龄期；年纪
年下	としした	名	比……年纪小、年幼
年玉	としだま	名	压岁钱
年の瀬	としのせ	連語	年关、年末
土砂降り	どしゃぶり	名	倾盆大雨
図書	としょ	名	图书
途上	とじょう	名	途上、过程中
土壌	どじょう	名	土壤
年寄り	としより	名	老年人
綴じる	とじる	他上一	订上、缝上
閉じる	とじる	自他上一	关、闭；关、合上；结束、关闭
都心	としん	名	都市中心
途絶，杜絶	とぜつ	名，サ変	中断
塗装	とそう	名，サ変	涂漆
土足	どそく	名	穿着鞋；泥脚
土台	どだい	名，副	地基；基础；本来
途絶える，跡絶える	とだえる	自下一	中断
戸棚	とだな	名	橱柜
どたばた	どたばた	副，サ変	（脚步声）啪哒啪哒作响
途端	とたん	名	正当……时候、刚……就
土壇場	どたんば	名	最后关头、绝境
土地	とち	名	土地；地面、地皮；当地
土着	どちゃく	名，サ変	土著、定居
途中	とちゅう	名	路途；（工作等）中途
どちら	どちら	代	哪儿；哪里；（敬语）哪位
読解	どっかい	名，サ変	阅读理解
どっかり	どっかり	副	沉重的样子；突然、急剧
突起	とっき	名，サ変	突起
特急	とっきゅう	名	特快
特許	とっきょ	名	特许；专利
疾っく	とっく	副	很久以前、老早
嫁ぐ	とつぐ	自五	出嫁
特訓	とっくん	名，サ変	特别训练
特権	とっけん	名	特权
咄嗟	とっさ	名	瞬间
どっさり	どっさり	副	很多
突如	とつじょ	副	突然、冷不防
どっしり	どっしり	副，サ変	（看上去）沉重；稳重
突然	とつぜん	名	忽然
どっち	どっち	代	[どっら]的简慢的说法
どっちつかず	どっちつかず	名，形動	摇摆不定
どっち道	どっちみち	副	总之
取手	とって	名	把手
取って置き	とっておき	名	珍藏（物）
突入	とつにゅう	名，サ変	冲进、闯入
突破	とっぱ	名，サ変	突破；超过
突発	とっぱつ	名，サ変	突发
どっぷり	どっぷり	副	蘸满、沉浸
土手	どて	名	堤坝
途轍	とてつ	名	道理
とても	とても	副	怎么也；及其
届く	とどく	自五	送到、到达；及、够；无遗漏、周到；（心愿）得偿、（希望）达到
届け出る	とどけでる	他下一	申报
届ける	とどける	他下一	报告；送到
滞る	とどこおる	自五	拖欠；拖延、延误
整う	ととのう	自五	齐整、端正
調う	ととのう	自五	达到、成立
整える	ととのえる	他下一	整理
調える	ととのえる	他下一	谈妥；准备
とどのつまり	とどのつまり	副	归根结底
止まる	とどまる	自五	止于、限于
留まる	とどまる	自五	停留
止める	とどめる	他下一	止住、停止；限于（某种程度）
留める	とどめる	他下一	留下
轟く	とどろく	自五	轰鸣；跳动；（名声）响震
唱える	となえる	他下一	念诵；高喊；提倡；倡导
称える	となえる	他下一	称呼、自称
どなた	どなた	代	（谁的敬语）哪位
隣	となり	名	邻居；邻近
怒鳴る	どなる	自五	大声喊、怒喊
兎に角	とにかく	副	总之；姑且（不谈）
どの	どの	連体	哪个
殿様	とのさま	名	老爷、大人；对身份高贵的武将的敬称；公子哥儿
賭博	とばく	名	赌博
飛ばす	とばす	他五	使……飞、放；溅、喷；飞驰、疾驰；跳过；散布；被降职
度外れ	どはずれ	名，形動	异常、特别
飛び交う	とびかう	自五	纷飞
飛び回る	とびまわる	自五	（到处）奔跑；东奔西走
土俵	どひょう	名	土袋子；（相扑）摔跤场
扉	とびら	名	门扉；书的扉页
跳ぶ	とぶ	自五	跳、越
飛ぶ	とぶ	自五	飞、飞跑；飞扬、飞溅；断、脱落；烟消云散、无影无踪；（号码等）不连接；散布、流传
溝	どぶ	名	下水道、污水沟
徒歩	とほ	名	徒步
途方	とほう	名	方法
土木	どぼく	名	土木（工程）
恍ける，惚ける	とぼける	自下一	（头脑）迟钝；假装不知；做出滑稽行为
乏しい	とぼしい	形	不足；贫困
とぼとぼ	とぼとぼ	副	疲劳地、有气无力地；蹒跚地
土間	どま	名	（不铺地板的）房间；剧场舞台正面的观览席
戸惑い	とまどい	名	困惑、彷徨
戸惑う	とまどう	自五	不知所措
止まる	とまる	自五	原地不动；中止；（鸟、飞虫等）落于某处休息、栖在
留まる	とまる	自五	固定住；留（在印象中）
泊まる	とまる	自五	停泊；投宿、住宿
富む	とむ	自五	富裕；丰富、富于
弔う	とむらう	他五	吊唁；祭奠
留め金，止め金	とめがね	名	别扣、金属卡子
止める	とめる	他下一	使……停下；堵住；制止、禁止
留める	とめる	他下一	固定住；系、扣；留住、记住
泊める	とめる	他下一	留住、留宿
供	とも	名	随员
友	とも	名	友人、朋友
兎も角	ともかく	副	不管怎样；姑且不论
ともすると	ともすると	副	常常、动辄
ともすれば	ともすれば	副	常常
共倒れ	ともだおれ	名	两败俱伤、同归于尽
友達	ともだち	名	友人、朋友
伴う	ともなう	他五	伴随；带领；相称
共に	ともに	副	一起；都、均；同时、相伴着
共働き	ともばたらき	名，サ変	夫妇双方都工作、双职工
点る，灯る	ともる	自五	点（灯）
どもる	どもる	自五	口吃
どやどや	どやどや	副	吵吵嚷嚷、（一窝蜂似的）涌出、涌进
銅鑼	どら	名	锣、锣鸣
捕らえる	とらえる	他下一	逮捕；抓、握
捉える	とらえる	他下一	把握、领会；占据
どら息子	どらむすこ	名	败家子
囚われる，捕らわれる	とらわれる	自下一	被俘；拘泥于
鳥，鶏	とり	名	指鸟类；鸡；山鸡
取り合う	とりあう	他五	争夺；理睬；手牵手
取り敢えず	とりあえず	副	急忙；立刻；首先、暂先
取り上げる	とりあげる	他下一	拿起；采用、受理；没收；接生
取り扱う	とりあつかう	他五	使用、处理；办理；对待
取り急ぎ	とりいそぎ	副	急速；立即
取り入る	とりいる	自五	讨好、巴结
取り入れる	とりいれる	他下一	收进；收割；采用、引进
取り柄	とりえ	名	长处
取り返す	とりかえす	他五	找回、夺回；恢复、挽回
取り替えす	とりかえる	他下一	交换；更换、更新
取り掛かる	とりかかる	自五	开始、着手
取り組む	とりくむ	自五	以……为对手；（为处理某事而）埋头苦干
取り消す	とりけす	他五	取消、撤销
虜，擒，俘，囚，俘虜	とりこ	名	俘虏；热衷于某事的人
取り込む	とりこむ	自他五	拿进来；占领、占为己有；侵吞；忙乱、忙碌；笼络、拉拢
取沙汰	とりざた	名，サ変	谈论、评论
取り捌く	とりさばく	他五	处理、调处
取り締まる	とりしまる	他五	掌管；监管、监视、取缔
取り澄ます	とりすます	自五	装摸做样、道貌岸然
取り立てる	とりたてる	他下一	征收、催缴；提拔；特别提起
取り付く	とりつく	自五	缠着、围着；着手、开始；（不好的东西）附体；（被）缠住
取り次ぐ	とりつぐ	他五	传达、通报；代销、代办
取り繕う	とりつくろう	他五	缝补、修理；粉饰、遮掩
取り付ける	とりつける	他下一	安装；取得、达成
取り直す	とりなおす	他五	改变拿法；重又拿起；重振（精神）
取り成す，執り成す	とりなす	他五	说和、调停；斡旋、周旋；劝解
取り除く	とりのぞく	他五	拆除、除掉
鳥肌	とりはだ	名	鸡皮疙瘩
取り引き	とりひき	名，サ変	贸易；交易
取り巻く	とりまく	他五	围绕、包围；逢迎、捧场
取り乱す	とりみだす	他五	弄乱；失掉理智、惊慌失措
取り持つ	とりもつ	他五	斡旋、撮合；应酬、接待
塗料	とりょう	名	涂料
度量	どりょう	名	长度与容积；气度、胸襟
努力	どりょく	名，サ変	努力
採る	とる	他五	采取、采用；选择；雇用
撮る	とる	他五	摄影；拍电影
執る	とる	他五	处理、实行；拿；执笔
取る	とる	他五	拿、握、攥；除掉、去掉；夺取、偷盗；掌权；掌管天下；获得；拿取（食物）、进行（睡眠等）；占据（时间、空间）；征收；记下；理解；确保；保存；订阅；上了年纪；接受、承担；采取措施、用手段；测量、计算；诊脉
捕る	とる	他五	抓住
何れ	どれ	代	哪个
どれ	どれ	感動	喂、哎
奴隷	どれい	名	奴隶；耽迷……的人
どれどれ	どれどれ	感動	“どれ”的强调说法、语气更强
何れ程	どれほど	副	多么、何等
獲れる	とれる	自下一	捕、捉
撮れる	とれる	自下一	照相
取れる	とれる	自下一	脱落；消除；收获、出产；届时成为、理解；协调
泥	どろ	名	泥；不好的、羞耻的事；小偷小摸
泥臭い	どろくさい	形	土腥气；土气、不文雅
蕩ける	とろける	自下一	溶化、溶解；心荡神驰、销魂
泥縄	どろなわ	名	临渴掘井、临时抱佛脚
泥沼	どろぬま	名	泥潭、泥沼；泥坑、难以自拔的困境
泥棒	どろぼう	名	小偷、偷窃
問わず	とわず	副	不论、不限
度忘れ	どわすれ	名，サ変	一时想不起来、突然忘记
丼	どん	名	大海碗
鈍化	どんか	名，サ変	变钝、停滞
豚カツ	とんかつ	名	炸猪排
鈍感	どんかん	名，形動	迟钝、不敏感
頓狂，頓興	とんきょう	名，形動	突然狂叫
団栗	どんぐり	名	橡树、橡子
鈍行	どんこう	名	慢车
頓着	とんじゃく	名，サ変	介意、放在心上
どん底	どんぞこ	名	底层、最下层；最糟的状态
とんだ	とんだ	連体	意外的；不可挽回的
頓知，頓智	とんち	名	机智、机敏
どんちゃん騒ぎ	どんきゃんさわぎ	名	喝酒喧闹
頓珍漢	とんちんかん	名，形動	（说话、做事）前后不符、自相矛盾
とんでもない	とんでもない	形	意外；哪有的事
どんどん	どんどん	副	（鼓等的）咚咚声；接连不断、一个劲儿的
どんな	どんな	連体	什么样的、怎样的
蜻蛉	とんぼ	名	蜻蜓；翻筋斗
問屋	とんや	名	批发商（公司、店）
貪欲	どんよく	名，形動	贪得无厌、贪婪
名	な	名	名称、名字；名声、声誉；名义、名目
無い，亡い	ない	形	无、没有；死去
ない	ない	補助動词	不、没有
内因	ないいん	名	内因
内科	ないか	名	内科
内外	ないがい	名	内外、国内外；左右、前后
内閣	ないかく	名	内阁
蔑ろ	ないがしろ	形動	轻视、忽视
内勤	ないきん	名，サ変	内勤、在办公室工作
内向	ないこう	名	内向
内在	ないざい	名，サ変	内在
内緒	ないしょ	名	秘密；生计、生活
内職	ないしょく	名，サ変	副业、兼职；（主妇或学生们）打工
内心	ないしん	名	内心
内装	ないそう	名	内部装饰
内臓	ないぞう	名	内脏
内蔵	ないぞう	名，サ変	内部装有、蕴藏
内地	ないち	名	国内；内陆；指本州
内定	ないてい	名，サ変	内定
内部	ないぶ	名	内部；内部（人）
内分泌	ないぶんぴつ	名	内分泌
内面	ないめん	名	里面、内部；精神及心理方面
内容	ないよう	名	内容
内陸	ないりく	名	内陆、大陆
綯う	なう	他五	搓、捻
苗	なえ	名	苗、秧苗
萎える	なえる	自下一	没精神、萎靡、没劲儿；枯萎、蔫
尚，猶	なお	副	尚、仍然；更
尚且つ	なおかつ	副	更、而且还、仍然
治す，直す	なおす	他五	修改、订正；治疗；更改、变更；（在动词的连用形后）重做、改作
直る，治る	なおる	自五	改正、矫正、修理；痊愈；（向更高一级）转变、升格
中	なか	名	内部、里面；（事物）进行中；（顺序）中等、中级
仲	なか	名	关系、交情
長雨	ながあめ	名	淫雨
長い,永い	ながい	形	距离远的、长的；（时间）长；永别；耐性好
長生き	ながいき	名，サ変	长寿
流し	ながし	名	冲、流；厨房水池、澡堂冲澡处；流动、串街（卖唱、揽客）
流す	ながす	他五	使液体流动；冲；冲洗；播放（声音、音乐等）；传播；流放；（艺人、出租车等）串街揽客；（典当东西）当死；（聚会、集会等）停止、作罢
長袖	ながそで	名	长袖
長続き	ながつづき	名，サ変	持久
中でも	なかでも	副	其中、有气
中中	なかなか	副，形動	非常、相当（下接否定）轻易、容易
長年，永年	ながねん	名	多年、长年累月
半ば	なかば	名，副	一半；中途；正中间
長引く	ながびく	自五	拖延
仲間	なかま	名	伙伴、同事、朋友；同类
中身	なかみ	名	装在容器里的东西、内容
眺める	ながめる	他下一	眺望、凝视
長持ち	ながもち	名，サ変	经久耐用
中休み	なかやすみ	名，サ変	中间休息
仲良し	なかよし	名	友好、好朋友
ながら	ながら	接続，接尾	虽然、尽管；一边……一边；都、全；原样
莫れ，勿れ	なかれ	連語	不要、莫
流れ	ながれ	名	流、河流；系统、流派；漂泊；趋势、潮流
流れる	ながれる	自下一	流、淌；漂流；（如水流般）流动、飘动；（岁月、时光）流逝；漂泊；（典当东西）当死；中止
就中	なかんずく	副	特别、尤其
泣き声	なきごえ	名	哭声
鳴き声	なきごえ	名	啼声、叫声
渚	なぎさ	名	水滨、岸边
泣き面	なきつら	名	哭脸
泣きべそ	なきべそ	名	撇嘴要哭的样子
泣き虫	なきむし	名	爱哭的人
泣く	なく	自五	啼哭、哭泣；感觉为难、吃苦头、懊悔；忍痛降价
鳴く	なく	自五	（鸟等）鸣叫、啼叫
慰み	なぐさみ	名	消遣、解闷、娱乐；捉弄、玩弄
慰める	なぐさめる	他下一	宽慰、安慰；慰问、抚慰
無くす	なくす	他五	消除；丢失
亡くす	なくす	他五	丧、死
無くなる	なくなる	自五	完、尽、遗失
亡くなる	なくなる	自五	死、故去
殴る	なぐる	他五	殴打
投げ掛ける	なげかける	他下一	披上；投掷、投到；提出（疑问）；偎靠
嘆く	なげく	自他五	悲伤、忧愁；愤慨
投げ出す	なげだす	他五	扔、抛；豁出、拿出；放弃
なけなし	なけなし	名，形動	仅有一点点
投げ遣り	なげやり	名，形動	（把工作等）扔下；草率、马虎
投げる	なげる	他下一	投、扔；跳入；投射；放弃
仲人	なこうど	名	媒人
和む	なごむ	自五	平静、温和
和やか	なごやか	形動	和谐、安详
余波	なごり	名	（浪退后）留在海滨的海水
名残	なごり	名	残余、痕迹；依恋、留恋
名残惜しい	なごりおしい	形	惜别、依依不舍
情け	なさけ	名	人情、情义；慈悲、同情；雅趣、情趣；爱情
情けない	なさけない	形	可怜、可叹、悲惨；无情、冷酷
名指し	なざし	名	指名
為さる	なさる	他五	（する）的尊敬语；接动词连用形做敬语用
無し	なし	名	无、没有
梨	なし	名	梨树；梨子
馴染む	なじむ	自五	适应、熟识；溶化、溶合
生す	なす	他五	生、产
成す，為す	なす	他五	做、为；完成、达到目标；变为；形成、构成
茄子	なす	名	茄子
擦り付ける	なすりつける	他下一	涂上、抹上；推诿、转嫁
擦る	なする	他五	涂上、擦上；推诿、转嫁
何故	なぜ	副	为什么、何故
謎	なぞ	名	谜语；神秘的；谜一般的事物
なぞる	なぞる	他五	描（字或画等）；套用
名高い	なだかい	形	闻名的
菜種	なたね	名	油菜籽
宥める	なだめる	他下一	劝、哄、安慰
なだらか	なだらか	形動	平缓；稳妥、顺利
雪崩	なだれ	名	雪崩
夏	なつ	名	夏天
捺印	なついん	名，サ変	盖章
懐かしい	なつかしい	形	（令人）怀念、眷恋、依恋
懐く	なつく	自五	亲近、驯服
名付ける	なづける	他下一	命名、起名
納豆	なっとう	名	经发酵后制成的大豆食品
納得	なっとく	名，サ変	同意；理解
夏場	なつば	名	夏季、夏天
撫でる	なでる	他下一	抚摸、抚摩；梳整头发
等	など	副助	等等、之类；表示轻视或谦逊；表示例举
名無し	ななし	名	无名、无名无姓
斜め	ななめ	名，形動	斜、倾斜；非同寻常、欠佳
何	なに	代，副，感	什么；那、那个任何；（用以否定对方的话）哪里、没什么；表示意想不到、惊愕
何気ない	なにげない	形	若无其事；无意
何しろ	なにしろ	副	不管怎样、总之
何者	なにもの	名	谁
何物	なにもの	名	什么、什么东西
何やら	なにやら	副	什么、某些；总觉得
何より	なにより	副	比什么都（好）
名乗る	なのる	自他五	自报姓名；自称、冒称；作为自己的名（姓）
靡く	なびく	自五	随着（风、水等）飘动、流动；屈从；依从
名札	なふだ	名	姓名牌、姓名卡
嬲る	なぶる	他五	嘲弄
鍋	なべ	名	锅；火锅
生	なま	名	（植物、动物未经加工过的）生；自然、直接；不到火候、不充分；现场演奏
生	なま	接頭	（接用言）总有些、略微；表示不充分、不成熟
生意気	なまいき	名，形動	傲慢、狂妄
名前	なまえ	名	姓名、名字；（事物的）名称
生臭い	なまぐさい	形	鱼腥；血腥；俗气的
怠け者	なまけもの	名	懒汉
怠ける	なまける	自下一	懒惰
生ごみ	なまごみ	名	（厨房扔掉的）含有水分的垃圾
艶かしい	なまめかしい	形	艳丽、妖艳
訛る	なまる	自他五	发讹音、发乡音
波，浪	なみ	名	波浪；波浪形的声波、地震波、电波等
並	なみ	名，接尾	普通、一般、平常排列、并列；每；同样
並木	なみき	名	行道树、林荫树
涙	なみだ	名	眼泪；同情
波み立つ	なみだつ	自五	起浪；（如波浪般）起伏、不平静；起风波
並並	なみなみ	名	普通（解否定，表示“非同寻常的”）
並外れる	なみはずれる	自下一	不寻常、非凡
滑らか	なめらか	形動	光滑；流利、顺溜
嘗める，舐める	なめる	他下一	舔；品尝；经历；火烧；轻视、嘲弄
悩み	なやみ	名	烦恼
悩む	なやむ	自五	（肉体的）痛苦；烦恼；（接动词连用形之后，表示该动作）不能顺利进行
なら	なら	接助，副助，接続	如果；就……方面来说；如果那样、那么
習い事	ならいごと	名	要学习的技艺
習う	ならう	他五	学习、练习
倣う	ならう	他五	模仿
慣らす	ならす	他五	使……习惯
馴らす	ならす	他五	驯养
均す	ならす	他五	平整；平均
鳴らす	ならす	他五	鸣响、（使）出声；出名、驰名；数落
生らず者	ならずもの	名	无赖
並びに	ならびに	接続	以及
並ぶ	ならぶ	自五	排成列；匹敌
並べる	ならべる	他下一	排列；（整齐地）摆；比较；一一列举
慣わし	ならわし	名	风俗、习惯
成金	なりきん	名	暴发户
成り立ち	なりたち	名	成立的经过；构成
成り立つ	なりたつ	自五	成立、构成、组成；划得来、能维持
成り行き	なりゆき	名	趋势、变迁、结果
成る，生る	なる	自五	结果实；成为、到达；变成……状态；变得……；到（某时刻、某个数量）；起作用；（お+动词的ます形+になる）构成敬语
鳴る	なる	自五	鸣、响；驰名、闻名
なるべく	なるべく	副	尽可能
成る程	なるほど	副，感	的确；（用于肯定对方的话）的确如此
馴れ合う	なれあう	自五	相好；男女私通；串通、合谋
馴れ馴れしい	なれなれしい	形	亲密；熟不拘礼
慣れる	なれる	自下一	习惯、习以为常；熟练；惯于……
馴れる	なれる	自下一	驯熟
熟れる	なれる	自下一	味道出来、腌好
縄	なわ	名	绳；特指绑犯人的绳索
縄張り	なわばり	名	圈绳定界；（圈定）势力范围、地盘
難	なん	名	困难；苦难；责难；缺点；（组成复合词）表示难于、困难
何	なん	代	何、什么
南下	なんか	名，サ変	南下
軟化	なんか	名，サ変	软化；（强硬的态度、主张）软化
難関	なんかん	名	难关；难以突破的僵局、场面
南極	なんきょく	名	南极
軟禁	なんきん	名，サ変	软禁
難航	なんこう	名，サ変	难以航行；（事情等）难以进展
軟膏	なんこう	名	软膏
難産	なんざん	名	（胎儿）难产；（喻）事物难产
軟弱	なんじゃく	名，形動	不结实、松软；（态度）怯懦、软弱
難色	なんしょく	名	难色、不同意
何だか	なんだか	副	总觉得
何だって	なんだって	連語，感	不管怎样；为什么；什么
何て	なんて	副	多么、何等
何で	なんで	副	为什么
何でも	なんでも	連語，副	不管什么；不论有什么；大概、据说是
何でもない	なんでもない	連語	算不了什么、不要紧
何と	なんと	副，感	怎么、如何；表示感叹
何か	なんか	連語，副	表示不定的事物；总算；设法
何となく	なんとなく	副	总觉得、不由得
難なく	なんなく	副	轻而易举地
南方	なんぽう	名	南方
南北	なんぼく	名	南北
難民	なんみん	名	难民
難問	なんもん	名	难题
二	に	名	二、两个
似合う	にあう	自五	合适、般配
兄さん	にいさん	名	哥哥；对年轻男子的称呼
新妻	にいづま	名	新婚妻子
煮える	にえる	自下一	煮熟；（水）烧开了；非常气愤
匂い，臭い	におい	名	香气；臭味；气息、情绪
匂う，臭う	におう	自五	散发气味；（颜色）显得鲜艳；（做坏事的）样子、迹象
匂わせる	におわせる	他下一	散发；暗示
苦い	にがい	形	苦；不愉快、痛苦
似顔	にがお	名	肖像
逃がす	にがす	他五	放跑；没抓住
苦手	にがて	名，形動	不好对付的人；不擅长、不善于
苦苦しい	にがにがしい	形	很讨厌、非常不痛快
苦味	にがみ	名	苦味
苦虫	にがむし	名	想象中的一种嚼时会发苦的虫子
似通う	にかよう	自五	相似、相仿
にきび	にきび	名	粉刺
賑やか	にぎやか	形動	热闹、繁华；闹哄哄
握り	にぎり	名	握、一把（量）；把手；（“握り飯”、“握りずし”的略语）饭团
握る	にぎる	他五	握、攥；攥饭团；掌握
賑わう	にぎわう	自五	热闹、繁华
賑わす	にぎわす	他五	使热闹、使繁华
肉	にく	名	（人的）肌肉；肉类；果肉；肉体；（肌肉或者物体的）厚度；印泥
憎い，悪い	にくい	形	可憎、讨厌；漂亮、令人佩服
難い，悪い	にくい	接尾	（接动词连用形）很难、不好办
肉食	にくしょく	名，サ変	肉类食品；肉食
肉親	にくしん	名	亲骨肉
肉体	にくたい	名	肉体
憎たらしい	にくたらしい	形	可憎、讨厌
憎まれっ子	にくまれっこ	名	谁都讨厌的孩子
憎む	にくむ	他五	憎恶、恨
憎らしい	にくらしい	形	可憎、可恨；令人嫉妒
逃げ足	にげあし	形	逃跑（速度）
逃げ道	にげみち	名	退路；逃避（责任）的方法
逃げる	にげる	自下一	逃跑；逃避（责任等）
濁す	にごす	他五	弄混；含糊（其词）
にこにこ	にこにこ	副，サ変	笑眯眯
にこやか	にこやか	形動	和颜悦色
濁る	にごる	自五	混浊；污浊、混乱；（声音）不清晰；发浊音
西	にし	名	西风；（佛）西天、净土；西欧各国
虹	にじ	名	彩虹
二次	にじ	名	（第）二次；其次、次要
二次会	にじかい	名	宴会完了后再次（在别的地方）举行的宴会
錦	にしき	名	锦缎
滲む	にじむ	自五	洇；渗出；反映出
二重	にじゅう	名	双层；重复
にじる	にじる	自他五	膝行；（用脚踩住）碾；践踏
偽，贋	にせ	名	假冒、赝品
二世	にせい	名	二世；继承人、第二代、儿子；（只生在移民低；拥有该国公民权的）第二代
偽物，贋物	にせもの	名	冒牌货
偽者，贋者	にせもの	名	冒充的人
似せる	にせる	他下一	模仿、伪造
煮炊き	にたき	名，サ変	做饭
日時	にちじ	名	日期和时刻；日数和时间
日常	にちじょう	名	日常、平常
日没	にちぼつ	名	日落
日夜	にちや	名，副	每天、昼夜
日用	にちよう	名	日用
似つかわしい	につかわしい	形	合适、相称
日記	にっき	名	日记；日记本
日給	にっきゅう	名	日薪
荷作り	にづくり	名，サ変	包装（货物）、包捆（行李）
日光	にっこう	名	日光
日射病	にっしゃびょう	名	中暑
日章旗	にっしょうき	名	（日本国旗）太阳旗
日数	にっすう	名	日数
日中	にっちゅう	名	白天；日本和中国
日程	にってい	名	日程
担う，荷う	になう	他五	担、挑；担负
二の句	にのく	名	第二句话
鈍い	にぶい	形	钝的；（光、音）弱；（动作、思想）迟钝、迟缓
荷札	にふだ	名	货签
鈍る	にぶる	自五	变钝、不快；减弱、变弱
日本	にほん	名	日本
二枚目	にまいめ	名	（戏剧）小生；美男子
荷物	にもつ	名	货物、行李；负担、累赘
にやにや	にやにや	副，サ変	独笑貌、嗤笑貌
入院	にゅういん	名，サ変	入院
乳液	にゅうえき	名	乳液；（化妆用的乳液）
入荷	にゅうか	名，サ変	进货、到货
入学	にゅうがく	名，サ変	入学
入国	にゅうこく	名，サ変	入国
入札	にゅうさつ	名，サ変	投标
入試	にゅうし	名	入学考试的略语
入社	にゅうしゃ	名，サ変	进入公司（工作）
入場	にゅうじょう	名，サ変	入场
乳製品	にゅうせいひん	名	乳制品
入籍	にゅうせき	名，サ変	户籍登记、结婚登记
入選	にゅうせん	名，サ変	入选
入門	にゅうもん	名，サ変	成为弟子；入门手册；初学
入浴	にゅうよく	名，サ変	入浴、沐浴
入力	にゅうりょく	名，サ変	输入
女房	にょうぼう	名	古代宫中女官；妻子
如実	にょじつ	名	如实、真实
韮	にら	名	韭菜
睨む	にらむ	他五	瞪；估计；监视、盯上
似る	にる	自上一	象、似；大同小异
煮る	にる	他上一	煮
庭	にわ	名	庭院；特定场所
俄	にわか	形動，名	突然；立刻、暂时；即兴狂言的略语
俄雨	にわかあめ	名	骤雨
鶏	にわとり	名	鸡
任意	にんい	名，形動	任意、随意；自发性的行为
認可	にんか	名，サ変	许可、认可
人気	にんき	名	人望、人缘；风气
任期	にんき	名	任期
人形	にんぎょう	名	偶人；傀儡、没有独立性的人
人間	にんげん	名	人类；人品
認識	にんしき	名，サ変	认识、理解
忍者	にんじゃ	名	隐秘行动的刺探敌情的人
忍従	にんじゅう	名，サ変	隐忍服从
人称	にんしょう	名	人称
人情	にんじょう	名	人情
妊娠	にんしん	名，サ変	怀孕
人参	にんじん	名	胡萝卜；人参
人数	にんずう	名	人数
任ずる	にんずる	サ変	自命；任命
忍耐	にんたい	名，サ変	忍耐
任地	にんち	名	工作地点
認知	にんち	名，サ変	认知
認定	にんてい	名，サ変	认定
大蒜	にんにく	名	大蒜
人夫	にんふ	名	小工、搬运工
妊婦	にんぷ	名	孕妇
任務	にんむ	名	任务、职责
任命	にんめい	名，サ変	任命
任免	にんめん	名，サ変	任免
任用	にんよう	名，サ変	任用
縫いぐるみ	ぬいぐるみ	名	（内填棉絮德）布制（动物）玩偶；（剧）扮演动物的兽形罩衣
縫い物	ぬいもの	名	针线活、缝纫；待缝或缝好的活儿
縫う	ぬう	他五	缝；穿过空隙
糠	ぬか	名	糠
抜かす，吐かす	ぬかす	他五	失去力气或劲头；省略、跳过；胡说、扯
抜き	ぬき	名，接尾	去掉；食品里省去通常放入的东西；开瓶子起子的略语；连胜
抜き出す	ぬきだす	他五	拔出、选出
抜き取る	ぬきとる	他五	拔出、拿掉；选出；窃取
抜きん出る	ぬきんでる	自下一	出类拔萃
抜く	ぬく	他五	拔出；选出；除掉；窃取；省掉；超过；胜过；（作补助动词）做到底
脱ぐ	ぬぐ	他五	脱掉、摘掉；脱下丢开
拭う	ぬぐう	他五	擦掉；消除、洗刷
温もり	ぬくもり	名	温和、暖和
抜け殻	ぬけがら	名	（蝉、蛇等）蜕下的皮或壳；失神的人
抜け出す	ぬけだす	自五	溜；开始脱落
抜け出る	ぬけでる	自下一	逃出、摆脱；杰出、出众
抜け目	ぬけめ	名	漏洞、疏忽
抜ける	ぬける	自下一	脱落、掉下；溜走；漏掉；穿过；消失；迟钝
脱げる	ぬげる	自下一	脱落下来
主	ぬし	名	主人；物主、所有者；老资格
盗む	ぬすむ	他五	偷盗；偷闲；背着、偷偷地；剽窃
布	ぬの	名	布；（接在其他名词之前表示）平、水平
布目	ぬのめ	名	布纹；布纹式花样
沼	ぬま	名	池沼
滑滑	ぬめぬめ	副，サ変	光滑、滑溜溜
濡らす	ぬらす	他五	润湿、弄湿
塗り物	ぬりもの	名	漆器
塗る	ぬる	他五	涂、抹
温い	ぬるい	形	半冷不热、不够热；不严厉
ぬるぬる	ぬるぬる	副，サ変	滑溜；粘乎乎
濡れ衣	ぬれぎぬ	名	冤枉
濡れ手	ぬれて	名	湿手
濡れる	ぬれる	自下一	湿、淋湿
根	ね	名	根；根底；根源、根据
値	ね	名	价格；价值、声价
値上げ	ねあげ	名，サ変	加价
音色	ねいろ	名	音色
値打ち	ねうち	名	价值
姉さん	ねえさん	名	（敬）姐姐；（对年轻女子的称呼）小姐；（对旅馆、饭店等的女服务员的称呼）大姐
願い	ねがい	名	愿望、请求
願い出る	ねがいでる	他下一	提出申请
願う	ねがう	他五	期望；请求、要求
寝返り	ねがえり	名	翻身；背叛
寝かす	ねかす	他五	使……睡觉；放倒；积压、存放不用；使……发酵
葱	ねぎ	名	大葱、香葱
労う	ねぎらう	他五	慰劳
値切る	ねぎる	他五	还价
寝癖	ねぐせ	名	头发睡乱；睡相；幼儿睡觉时的坏习惯
猫	ねこ	名	猫；艺妓
猫舌	ねこじた	名	不能吃热食的人
根こそぎ	ねこそぎ	名，副	根除；全部
寝言	ねごと	名	梦话；胡说、唠叨
値頃	ねごろ	名	价钱合适
寝転ぶ	ねころぶ	自五	横卧、随便躺下
値下げ	ねさげ	名，サ変	减价
根差す	ねざす	自五	生根、扎根；起因、由来
螺子	ねじ	名	螺钉、螺丝；上发条的装置
拗ける	ねじける	自下一	弯弯曲曲；（性情）乖僻
捻じ込む	ねじこむ	自他五	拧进；塞进；提出严重抗议
捻じ曲げる	ねじまげる	他下一	扭曲、歪曲
捻る，捩る	ねじる	他五	扭、拧
捻じれる，捩じれる	ねじれる	自下一	扭歪、乖僻
鼠	ねずみ	名	老鼠
ねた	ねた	名	素材；戏法等的道具；机关；（俗称）证据
寝たきり	ねたきり	名，サ変	（因衰老或病）卧床不起
妬ましい	ねたましい	形	嫉妒
妬む，嫉む	ねたむ	他五	嫉妒
強請る	ねだる	他五	撒娇、央求、强求
値段	ねだん	名	价格
熱	ねつ	名	热；热度；热情
熱意	ねつい	名	热忱、热情
熱気	ねっき	名	热空气；热情、蓬勃
熱狂	ねっきょう	名，サ変	狂热、兴奋
根付く	ねづく	自五	扎根、成活
熱血	ねっけつ	名	热血、热情
根っ子	ねっこ	名	根、根本、树桩
熱心	ねっしん	名，形動	热心、热情
熱する	ねっする	サ変	变热；兴奋、热衷；加热
捏造	ねつぞう	名，サ変	捏造
熱帯	ねったい	名	热带
熱中	ねっちゅう	名，サ変	热衷于
熱っぽい	ねつっぽい	形	发烧的、发热的；热情的
根強い	ねづよい	形	坚固的、根深蒂固的
熱烈	ねつれつ	形動	热烈的
寝床	ねどこ	名	卧室、床、铺
根無し	ねなし	名	无根；无根据
粘つく	ねばつく	自五	发粘、粘上
粘り強い	ねばりづよい	形	粘性强；坚忍不拔、有毅力
粘る	ねばる	自五	粘、发粘；坚持不懈
涅槃	ねはん	名	涅磐；圆寂
値引き	ねびき	名，サ変	减价、降价
根深い	ねぶかい	形	根深；由来已久的
値札	ねふだ	名	标价牌
寝坊	ねぼう	形動，名，サ変	睡懒觉的（人）
寝惚ける	ねぼける	自下一	睡意朦胧；色调不鲜明
根回し	ねまわし	名，サ変	（为移植或使果树增产）切断树的须根；（为达到目的、取得结果）事先做好有关方面的工作
寝耳	ねみみ	名	睡觉时的耳朵、睡觉中听到的
眠い	ねむい	形	想睡的
眠気	ねむけ	名	困倦、睡意
眠る	ねむる	自五	睡；长眠、死；埋藏、放置、不被利用
根元	ねもと	名	植物的根；根本
狙いどころ	ねらいどころ	名	着眼点
狙う	ねらう	他五	瞄准；伺机；以……为目标
練り歯磨き	ねりはみがき	名	牙膏
寝る	ねる	自下一	躺下；睡觉；因病卧床；积压
練る，煉る	ねる	自他五	列队游行；揉、和（面粉、馅等）；加工、锤炼；提高、修养
練れる	ねれる	自下一	熬炼好、成熟的；人经磨练而成熟
念	ねん	名	想法、念头；用心，注意
年	ねん	名	年、一年；年限的略语
念入り	ねんいり	名，形動	精心、用心
年賀	ねんが	名	贺年、拜年
年がら年中	ねんがらねんじゅう	副，サ変	一年到头、终年
年間	ねんかん	名	年间；（年号使用）期间
念願	ねんがん	名，サ変	愿望、希望
年忌	ねんき	名	每年的忌辰
年季	ねんき	名	奉公、效劳的年限；积累的经验
年貢	ねんぐ	名	岁贡、租税、地租
年功	ねんこう	名	资历、工龄；（长年工作掌握的）熟练技术，老练
懇ろ	ねんごろ	形動	亲切、殷勤；亲昵、亲密
年始	ねんし	名	年初；拜年
年中	ねんじゅう	名，副	一年间；始终
捻出	ねんしゅつ	名，サ変	冥思苦想出；设法安排、筹措
年少	ねんしょう	名，形動	年轻的
燃焼	ねんしょう	名，サ変	燃烧；竭尽全力做、不遗余力
念ずる	ねんずる	サ変	（向神佛）祈祷；祈愿
年代	ねんだい	名	年代；过去的年月；年龄层；年月日
粘着	ねんちゃく	名，サ変	粘着、粘附
年長	ねんちょう	名	年长
粘土	ねんど	名	粘土
念頭	ねんとう	名	念头
年配	ねんぱい	名	大致的年龄；中老年
念仏	ねんぶつ	名，サ変	念佛
年俸	ねんぽう	名	年俸
年末	ねんまつ	名	年末、岁尾
燃料	ねんりょう	名	燃料
年輪	ねんりん	名	（树木的）年轮；（事物逐年成长、变化的）历史过程
年齢	ねんれい	名	年龄
野	の	名，接頭	原野；野生的
能	のう	名	能力；（日本古典戏剧）能乐
農	のう	名	农业
脳	のう	名	脑；头脑、头脑的功能
農家	のうか	名	农家、农户
能楽	のうがく	名	（日本古典戏剧）能乐
納棺	のうかん	名，サ変	入棺、入殓
農閑期	のうかんき	名	农闲期
納期	のうき	名	交货期限；交税（款）期限
農業	のうぎょう	名	农业
濃厚	のうこう	形動	浓厚的；男女关系密切、亲密；浓厚、显著
農耕	のうこう	名	农耕
農場	のうじょう	名	农场
納税	のうぜい	名，サ変	纳税
農村	のうそん	名	农村
農地	のうち	名	农地、农田
濃度	のうど	名	浓度
能無し	のうなし	名	无能、没用的人
能筆	のうひつ	名	擅长书法（的人）、写字好（的人）
納品	のうひん	名，サ変	（向订户）交货
納付	のうふ	名，サ変	向乡政府机关等缴纳款项
能弁	のうべん	名，形動	能言善辩、雄辩
脳味噌	のうみそ	名	脑、脑汁、智力
農民	のうみん	名	农民
脳裏	のうり	名	脑海里
能率	のうりつ	名	效率
納涼	のうりょう	名，サ変	乘凉、消暑
能力	のうりょく	名	才能；（法律上）行为能力
農林	のうりん	名	农林业
逃す	のがす	他五	错过、漏掉
逃れる	のがれる	自下一	逃脱；逃避、避免；远离
軒	のき	名	屋檐
軒並み	のきなみ	名，副	房檐栉比；全部、毫无例外的
除け者	のけもの	名	被疏远的人、受排挤的人
退ける	のける	他下一	移开、使离开
除ける	のける	他下一	排除
鋸	のこぎり	名	锯子
残す	のこす	他五	剩下；留下
残らず	のこらず	副，サ変	全部
残る	のこる	自五	留下；剩余；残留；流产后世
のさばる	のさばる	自五	任意妄为、横行霸道
伸し上がる	のしあがる	自五	爬上（高位）、飞黄腾达
伸し掛かる	のしかかる	自五	压在……上
伸す	のす	自他五	发展；（活动范围等）延伸；熨平；打倒
載せる	のせる	他下一	放在……上；装载、装运；登载
乗せる	のせる	他下一	使……乘坐；传播、传导；和着（节拍、节奏）；骗人、欺骗；吸收参见、让参加
覗かせる	のぞかせる	他下一	露出事物的一部分
除く	のぞく	他五	除去；除外
覗く	のぞく	自他五	露处（物体的）一部分；从缝隙中看；窥视；粗略地看一下；向下看
望ましい	のぞましい	形	符合心愿、理想的
望む	のぞむ	他五	远望、眺望；期望
臨む	のぞむ	自五	面对、朝向；进发；面临、面对、遭遇
後	のち	名	……之后；将来
後後	のちのち	名	今后
乗っ取る	のっとる	他五	夺取、占领；劫持
則る	のっとる	自五	遵守、按照
のっぽ	のっぽ	名，形動	高个
喉	のど	名	喉咙、咽喉；歌声
のどやか	のどやか	形動	悠然的、悠静的、风和日丽的
罵る	ののしる	他五	骂
伸ばす	のばす	他五	伸展；伸直、使……平坦；稀释；打倒、打趴在地；扩展、发展
延ばす	のばす	他五	延长日期、时间
野放し	のばなし	名	（家畜）放养；放任、不加管束
野原	のはら	名	原野、野地
伸び縮み	のびちぢみ	名，サ変	伸缩、弹性
伸び悩む	のびなやむ	自五	停滞不前、行市呆滞
伸び伸び	のびのび	副，サ変	舒展、轻松、愉快
延び延び	のびのび	形動	延期
伸びる	のびる	自上一	变长、（褶皱等）伸展；失去弹性；增长、发展；筋疲力尽
延びる	のびる	自上一	延长、延期；时间变长
延べ	のべ	名	总计
伸べる	のべる	他上一	伸出；延迟、延缓
延べる	のべる	他上一	铺开
述べる	のべる	他上一	叙述、阐述
上せる	のぼせる	他上一	提出、提到
逆上せる	のぼせる	自下一	头晕；上火；沉溺、热衷于；骄傲、飘飘然
上り	のぼり	名	朝上移动、爬、登；上行（列车、巴士等）
上る	のぼる	自五	向上移动；溯流航行；就高位；从地方向首府移动；达到、高达；被提起
登る	のぼる	自五	登、爬、攀
昇る	のぼる	自五	升腾、升起
呑まれる	のまれる	自下一	被拉入、被拽入；被压倒
蚤	のみ	名	跳蚤
飲み込む，呑み込む	のみこむ	他五	吞下；理解、领会
飲み干す	のみほす	他五	喝光、喝干
飲み水	のみみず	名	饮用水
飲み物	のみもの	名	（水、酒、茶等）饮料
飲む，呑む	のむ	他五	喝、喝酒；抽、吸；接受；压倒、胜过；隐匿、隐藏
のめり込む	のめりこむ	自五	（身体）向前倒；陷入
野良	のら	名	原野；农田
野良犬	のらいぬ	名	野狗
海苔	のり	名	紫菜
糊	のり	名	浆糊、胶水
乗り換える	のりかえる	自下一	换乘；改变（主张、方针、所属等）
乗り掛かる	のりかかる	自五	正要赶上；开始
乗り気	のりき	名	感兴趣、起劲
のりくむ	のりくむ	自五	（为工作）同乘一条船
のりこえる	のりこえる	自下一	越过、跨过；超过；克服
乗り越す	のりこす	他五	坐过站、乘过头
乗り込む	のりこむ	自五	乘坐；开进、到达
乗り出す	のりだす	自他五	乘车外出；参与；身体向前探出
乗り場	のりば	名	乘（车、船）的地点
乗物	のりもの	名	交通工具
乗る	のる	自五	乘、坐、骑；登上；和着、附和；乘势、乘机；上当、受骗；附着、上膘
載る	のる	自五	放在上面；刊载、登载
暖簾	のれん	名	写有商号名称、挂在商店门上的窄布帘；商家的信用
鈍い	のろい	形	迟缓的；（头脑）迟钝的
呪う，詛う	のろう	他五	诅咒、咒骂
惚ける	のろける	自下一	津津乐道自己的风流韵事
のろのろ	のろのろ	副，サ変	缓慢、迟缓
呪わしい	のろわしい	形	可憎的、倒霉的
呑気	のんき	名，形動	悠闲的
飲んだくれ	のんだくれ	名	酒鬼、醉鬼
のんびり	のんびり	副，サ変	悠然自得、逍遥自在
葉	は	名	树叶
歯	は	名	牙齿；齿状物、器物的齿
刃	は	名	刃、刀刃
場合	ばあい	名	场合、时候；情况、状态
把握	はあく	名，サ変	把握；理解
敗	はい	名	败、输
肺	はい	名	肺
灰	はい	名	灰
這い上がる	はいあがる	自五	爬上；摆脱困境
廃案	はいあん	名	废案、废弃的提案
灰色	はいいろ	名	灰色；没希望的、阴郁；不鲜明；有渎职嫌疑的
敗因	はいいん	名	失败的原因
廃液	はいえき	名	废液、废水
配下	はいか	名	部下、手下
拝賀	はいが	名，サ変	拜贺、向尊长祝贺
俳諧	はいかい	名	有滑稽趣味的和歌、连歌；俳句
徘徊	はいかい	名，サ変	徘徊
媒介	ばいかい	名，サ変	媒介
廃刊	はいかん	名，サ変	停刊
排気	はいき	名，サ変	排气；排气（蒸汽、瓦斯等）
廃棄	はいき	名，サ変	废弃；废除
配給	はいきゅう	名，サ変	配给、（定量）供应
ばい菌	ばいきん	名	细菌
俳句	はいく	名	俳句
配偶者	はいぐうしゃ	名	配偶
拝啓	はいけい	名	敬启者（书信开头用语）
背景	はいけい	名	背景；舞台等的布景；后盾、靠山
拝見	はいけん	名，サ変	（“見ら”的自谦语）看、瞻仰
背後	はいご	名	背后；背地、幕后
灰皿	はいざら	名	烟灰缸
廃止	はいし	名，サ変	废止、废除、作废
拝借	はいしゃく	名，サ変	（“借りる”的自谦语）借
買収	ばいしゅう	名，サ変	收购；收买
排出	はいしゅつ	名，サ変	排除
輩出	はいしゅつ	名，サ変	辈出、涌现
賠償	ばいしょう	名，サ変	赔偿
排除	はいじょ	名，サ変	排除、排斥
敗色	はいしょく	名	败势、败相
排斥	はいせき	名，サ変	排斥
排泄	はいせつ	名，サ変	排泄
配線	はいせん	名，サ変	配线、架线
敗訴	はいそ	名，サ変	败诉
配送	はいそう	名，サ変	配送
配属	はいぞく	名，サ変	分配（到具体的工作单位）
配達	はいたつ	名，サ変	投递、投送
配置	はいち	名，サ変	配置、安置
配当	はいとう	名，サ変	分配；分红
拝読	はいどく	名，サ変	拜读
背任	はいにん	名，サ変	渎职
配布	はいふ	名，サ変	分发、散发
配分	はいぶん	名，サ変	分配
配役	はいやく	名	分配角色
俳優	はいゆう	名	演员
配慮	はいりょ	名，サ変	照顾、关照
入る	はいる	自五	进入；移动；缩入、太阳落山等；入学、进公司；装进、容纳；进入（某种状态、时期）；包含、含有；看、听
配列，排列	はいれつ	名，サ変	排列
這う	はう	自五	爬；攀缠
蠅	はえ	名	苍蝇
生え抜き	はえぬき	名	土生土长；（创业以来的）原来
映える，栄える	はえる	自下一	照、映照；惹人注目、显眼；映衬
生える	はえる	自下一	生长
羽織	はおり	名	套在和服外的短外套；日式外褂和裙裤、礼装
羽織る	はおる	他五	披上、穿上
墓	はか	名	墓
馬鹿	ばか	名，形動	愚蠢的人；无益的；过分、极端；不好使、不中用；……呆子
破壊	はかい	名，サ変	破坏
葉書	はがき	名	明信片
破格	はかく	名，形動	破格
剥がす	はがす	他五	剥下
博士	はかせ	名	博士；博学之士
捗る	はかどる	自五	顺利进展、推进
果敢ない	はかない	形	虚幻无常的；不能依赖、指望的
鋼	はがね	名	钢铁
捗捗しい	はかばかしい	形	迅速发展；进展顺利
馬鹿馬鹿しい	ばかばかしい	形	无聊、愚蠢
袴	はかま	名	（和服的）裙裤
歯がゆい	はがゆい	形	焦急的、懊悔的、不耐烦的
計らう	はからう	他五	商量；处理、适当处置
秤	はかり	名	秤
計り知れない	はかりしれない	連語	无法估量的
謀	はかりごと	名	计谋、策略
計る	はかる	他五	计算；评价、预测；欺骗、诈骗
図る	はかる	他五	计划；处理、照顾、安排
測る	はかる	他五	测量
量る	はかる	他五	测量、计算
諮る	はかる	他五	咨询、磋商
謀る	はかる	他五	图谋、策划
破棄	はき	名，サ変	废弃、废除、撕毁；撤销（判决）
萩	はぎ	名	（秋季七草之一）胡枝子
吐気	はきけ	名	恶心、做呕；令人不快的
はきはき	はきはき	副，サ変	伶俐、干脆、爽快
波及	はきゅう	名，サ変	波及
破局	はきょく	名	悲剧性的结果
歯切れ	はぎれ	名	牙咬东西的感觉；口齿
穿く，履く	はく	他五	穿鞋、袜等
佩く	はく	他五	佩戴
掃く	はく	他五	扫除；轻涂
吐く	はく	他五	喷出；呕吐、吐出；冒出；说出、吐露；招供
剥ぐ	はぐ	他五	剥；剥夺
博愛	はくあい	名	博爱
白衣	はくい	名	白色的衣服；白衣天使
迫害	はくがい	名，サ変	迫害
博学	はくがく	名，形動	博学
育む	はぐくむ	他五	孵、抱窝；养育；保护、培养
博士	はくし	名、	博士
白紙	はくし	名	白纸；原状；事前没有（成见、准备）
白日	はくじつ	名	太阳、白昼；光天化日
拍手	はくしゅ	名，サ変	拍手
白書	はくしょ	名	白皮书
白状	ｙｔｔｙｙｙ	名，サ変	坦白、交代
薄情	はくじょう	名，形動	薄情
博する	はくする	サ変	获得
莫大	ばくだい	形動	莫大、极大
爆弾	ばくだん	名	炸弹
博打	ばくち	名	赌博；听天由命的试一试
爆竹	ばくちく	名	爆竹
伯仲	はくちゅう	名，サ変	伯仲、不分上下
白鳥	はくちょう	名	白鸟、天鹅
爆発	ばくはつ	名，サ変	爆炸；爆发
幕府	ばくふ	名	幕府
博物館	はくぶつかん	名	博物馆
舶来	はくらい	名，サ変	舶来、进口
博覧	はくらん	名，サ変	多人观览；博览、博闻
薄利	はくり	名	薄利
迫力	はくりょく	名	动人的力量、扣人心弦
歯車	はぐるま	名	齿轮；比喻使组织运转的机械及其成员
はけ口	はけぐち	名	排水口；发泄对象；销路
激しい	はげしい	形	猛烈；剧烈
励ます	はげます	他五	激励；提高嗓门、厉声
励む	はげむ	自五	勤勉、勤奋
捌ける	はける	自下一	排水；售出
剥げる	はげる	自下一	脱落；暴露、败露
禿げる	はげる	自下一	脱落；山光秃秃的
化ける	ばける	自下一	化身为；乔装、冒充；骤变
覇権	はけん	名	霸权；优胜、冠军
派遣	はけん	名，サ変	派遣
箱	はこ	名	箱子；（电车，火车）车厢
羽子板	はごいた	名	毽球板
歯ごたえ	はごたえ	名	嚼头；有干劲、起劲
運び	はこび	名	搬运；移步、前往；进展、行进
運ぶ	はこぶ	自他五	进展；运送；前往；推进
挟まる	はさまる	自五	夹在；加在对立双方中间
鋏，剪刀	はさみ	名	剪刀；剪票钳
挟む	はさむ	他五	夹进、插进；夹；心生……
剪む	はさむ	他五	剪、铰
破産	はさん	名，サ変	破产
橋	はし	名	桥
端	はし	名	头、边缘；片断；零头、断片
箸	はし	名	筷子
恥，辱，羞	はじ	名	丢脸；廉耻新
弾く	はじく	他五	弹跳、弹力；不沾水；弹；打算盘
梯子	はしご	名	梯子；串酒馆、从这家喝到那家
はしたない	はしたない	形	卑鄙、下流
始まる	はじまる	自五	开始；开始（老一套行为）；（后接否定表示）无用、白费劲
始め，初め	はじめ	名	最初；起初；以……为首
始める	はじめる	他下一	开始；开始（老一套的行为）；开始做……
燥ぐ	はしゃぐ	自五	喧闹
場所	ばしょ	名	场所、地方；所占的位置；相扑赛季
柱	はしら	名	支柱；依靠
恥らう	はじらう	自五	害羞
走る	はしる	自五	跑；行驶、奔驰、运行；逃亡；倾向于（不好的方向）；（文笔）流畅；伸展；突然出现
恥じる	はじる	他上一	羞耻、惭愧；（用否定式表示）不愧为
橋渡し	はしわたし	名，サ変	搭桥、从中斡旋
斜	はす	名	斜
蓮	はす	名	莲、荷
筈	はず	名	理所当然；预定
恥ずかしい	はずかしい	形	不好意思的；害羞；感到羞愧
辱める	はずかしめる	他下一	侮辱；玷污
外す	はずす	他五	取下、解开；离席；避开；错过
蓮っ葉	はすっぱ	名，形動	（女人）轻浮、轻佻
弾み	はずみ	名	弹性；劲头；势头、（偶然的）机会；刹那
弾む	はずむ	自他五	弹、反弹；气息变粗；情绪高涨、起劲；（一狠心）拿出很多钱
外れる	はずれる	自下一	脱落、掉下；脱离、不合；未中、落空；相悖、不合（道理等）
派生	はせい	名，サ変	派生
馳せる	はせる	自他下一	跑；驱（车）；缅怀、驰名
破損	はそん	名，サ変	破损
旗	はた	名	旗帜
傍，側	はた	None	侧、旁、旁边
旗色	はたいろ	名	（战争、比赛等的）形势；所属、立脚点
肌，膚	はだ	名	皮肤；物体表面；气质
裸	はだか	名	裸体；身无分文；毫不隐瞒、坦诚
肌着	はだぎ	名	（贴身）内衣
叩く	はたく	他五	掸；拍、打；用光、花光
畑	はたけ	名	田地、旱田；专业领域
旅籠	はたご	名	以前的（饱餐）旅馆
肌触り	はだ触り	名	触感、手感；与人交往时的感觉
裸足	はだし	名	赤足、光着脚；敌不过
果たして	はたして	副	果然果真
果たす	はたす	他五	实现；光、尽
二十，二十歳	はたち	名	二十岁
働き	はたらき	名	工作；机能、作用；才能
働きかける	はたらきかける	自下一	发动；对……做工作
働く	はたらく	自他五	劳动、工作；作用；干坏事
破綻	はたん	名，サ変	破绽、失败
鉢	はち	名	钵；花盆；头盖骨
蜂	はち	名	蜜蜂、蜂
鉢合わせ	はちあわせ	名，サ変	头碰头；邂逅
はちきれる	はちきれる	自下一	满满的、撑破
破竹の勢い	はちくの勢い	連語	破竹之势
鉢巻	はちまき	名	（用布、毛巾等）缠头
波長	はちょう	名	波长
初	はつ	名	最初；（当年）第一次
罰	ばつ	名	惩罚、处罚
発案	はつあん	名，サ変	提议；提案
発育	はついく	名，サ変	发育
発音	はつおん	名，サ変	发音
薄荷	はっか	名	薄荷
二十日	はつか	名	二十号；二十天
発覚	はっかく	名，サ変	暴露、被发现
発揮	はっき	名，サ変	发挥
はっきり	はっきり	副，サ変	清楚；明确；清晰、明了；干脆、断然
罰金	ばっきん	名	罚款
発掘	はっくつ	名，サ変	挖掘；发掘
発見	はっけん	名，サ変	发现
発言	はつげん	名，サ変	发言
発現	はつげん	名，サ変	表现、体现、显现
初恋	はつこい	名	初恋
発酵	はっこう	名，サ変	发酵
発行	はっこう	名，サ変	（图书、报纸等的）发行；（货币、债券等的）发行
発散	はっさん	名，サ変	发散、散发；消散
発射	はっしゃ	名，サ変	发射
発車	はっしゃ	名，サ変	发车、开车
発祥	はっしょう	名，サ変	发源、发祥
抜粋	ばっすい	名，サ変	拔萃、摘录
発する	はっする	サ変	发生；发出；发表
発生	はっせい	名，サ変	发生、出现
発声	はっせい	名，サ変	发声、发音；领唱、领域
発想	はっそう	名，サ変	（思想、诗情等的）表现；主意、构思；（音乐的）表达，表现
発送	はっそう	名，サ変	发送、寄送
罰則	ばっそく	名	惩罚条例
発達	はったつ	名，サ変	（身体、精神等）发育、成长；发达；（低气压、台风的规模）扩大
はったり	はったり	名	虚张声势、故弄玄虚
ばったり	ばったり	副	突然倒下的样子；不期而遇；突然停止
発着	はっちゃく	名，サ変	出发和到达
発注	はっちゅう	名，サ変	订货
抜擢	ばってき	名，サ変	提拔、提升
発展	はってん	名，サ変	发展；（在酒色上）放荡
発電	はつでん	名，サ変	发电
発動	はつどう	名，サ変	发动；行使、动用
発売	はつばい	名，サ変	出售、发售
発病	はつびょう	名，サ変	发病、得病
発表	はっぴょう	名，サ変	发表、表明
初舞台	はつぶたい	名	初登舞台
発奮	はっぷん	名，サ変	发奋、振奋起来
八方	はっぽう	名	四面八方、各方面
抜本	ばっぽん	名	彻底、治本
初耳	はつみみ	名	初次听到
発明	はつめい	名，サ変，形動	发明；聪明、伶俐
初詣で	はつもうで	名	新年后初次惨败（神社、寺院）
溌剌	はつらつ	形動	活泼、精力充沛
果て	はて	名	边际、尽头；最后、末了、结局
派手	はで	形動	鲜艳、华美；铺张、显眼
果てる	はてる	自下一	终、尽、完毕；死；（接动词连用形后）达到极点
破天荒	はてんこう	名，形動	破天荒、未曾有过
鳩	はと	名	鸽
波止場	はとば	名	码头
歯止め	はどめ	名	车闸；制止
花	はな	名	花；樱花；花道；黄金时代；最好的；精华
鼻	はな	名	鼻子；鼻涕
鼻息	はないき	名	用鼻子呼气、鼻息
花形	はながた	名	花纹；名演员；有名的人物、红人
花盛り	はなざかり	名	花盛开；最盛的时候
話	はなし	名	谈话、话题；商量、商谈；故事；传言、谣传；道理；事情
話し合い	はなしあい	名	商量、协商
話し手	はなして	名	说话者、谈天的伙伴；健谈的人
放す	はなす	他五	放开、撤开；放掉、放走
離す	はなす	他五	分离、离开；间隔、隔开
話す	はなす	他五	说、讲；商量、商谈；说（外语等）
鼻血	はなぢ	名	鼻血
放つ	はなつ	他五	派遣；射箭；放；防（火）；放开、解放
鼻つまみ	はなつまみ	名	讨厌（的人）、惹人嫌（的人）
甚だ	はなはだ	副	非常、很
甚だしい	はなはだしい	形	非常、很
華々しい	はなばなしい	形	豪华、辉煌
花火	はなび	名	焰火、烟火
花見	はなみ	名	赏（樱）花
餞	はなむけ	名	饯别、饯行
花婿	はなむこ	名	新郎
華やか	はなやか	形動	引人注目、显赫
華やぐ	はなやぐ	自五	热闹起来、变得辉煌（盛大）起来
花嫁	はなよめ	名	新娘
離れる	はなれる	自下一	有距离、有差距；离开；分离、分开；脱离、背离
放れる	はなれる	自下一	脱开、脱离
離れ業	はなれわざ	名	惊人的技艺、绝技
はにかむ	はにかむ	自五	害臊、羞怯
埴輪	はにわ	名	（日本古代坟墓中的）土俑、陶俑
羽，羽根	はね	名	（鸟和昆虫等德）翅膀；羽毛；（机械等的）翼
発条	ばね	名	发条、弹簧；弹力
羽根突き	はねつき	名	板羽球
跳ね返る	はねかえる	自五	跳回、弹回；反过来影响
撥ね付ける	はねつける	他下一	拒绝
撥ね除ける	はねのける	他下一	推开；淘汰
跳ねる	はねる	自下一	跳；飞溅；散戏、散场；（行情）飞涨
刎ねる	はねる	他下一	砍掉
撥ねる	はねる	他下一	淘汰；提成、攫取；飞溅、撞飞；发拨音
母	はは	名	母亲；事物产生的根源、母
幅	はば	名	宽度；势力、威力；伸缩余地、灵活性；差价、幅度
祖母，婆	ばば	名	祖母、外祖母；老奶奶
母方	ははかた	名	母系
憚る	はばかる	自他五	有势力；顾忌
羽ばたく	はばたく	自五	振翅、拍打翅膀；活跃
幅広い	はばひろい	形	宽广；广泛
阻む	はばむ	他五	阻碍、阻止
蔓延る	はびこる	自五	蔓延；横行、泛滥
省く	はぶく	他五	精简；节省
破片	はへん	名	碎片
浜	はま	名	海滨、湖滨；横滨（的略称）
葉巻	はまき	名	雪茄烟
填まる，嵌まる	はまる	自五	吻合；合适、陷入、掉进；中计
食み出す	はみだす	自五	露出；超出、越出范围
食む	はむ	他五	吃；受禄、食俸
歯向かう，刃向かう	はむかう	自五	反抗
羽目，破目	はめ	名	板壁；困境
破滅	はめつ	名，サ変	灭亡
嵌める，填める	はめる	他下一	镶、嵌；戴上；欺骗
場面	ばめん	名	场面、场景；情景、光景
刃物	はもの	名	刀剑、刃具
波紋	はもん	名	波纹、涟漪；影响
速い	はやい	形	快、迅速
早い	はやい	形	早；为时尚早、还不到时候；时间短、快
早起き	はやおき	名，サ変	早起
早合点	はやがてん	名，サ変	贸然断定、自以为是
早口	はやくち	名	说话快
林	はやし	名	树林
囃子	はやし	名	（能乐、歌舞伎等的）伴奏
生やす	はやす	他五	使生长
囃す	はやす	他五	伴奏；齐声喝彩、呐喊嘲笑
早引け	はやびけ	名，サ変	（由学校、工作地点）早退
早まる	はやまる	自五	提前；仓促、轻率
速める	はやめる	他下一	加快、加速
早める	はやめる	他下一	提前
流行	はやり	名	流行
流行る	はやる	自五	流行；盛行；（疾病等）流行、蔓延；兴旺
原	はら	名	平原、原野
腹	はら	名	腹、肚子；鼓出的部分；内心、想法；度量
薔薇	ばら	名	蔷薇、玫瑰
払う	はらう	他五	拂、掸；横扫、横砍；支付；倾注、表示
祓う	はらう	他五	驱除、拔除
腹黒い	はらぐろい	形	心眼儿坏、阴险
腹ごしらえ	はらごしらえ	名，サ変	（开始工作或干活之前）先吃好饭
腹ごなし	はらごなし	名	助消化、消食
腫らす	はらす	他五	使……肿胀
晴らす	はらす	他五	解除、消除（疑虑、愁闷、怒气等）
ばらす	ばらす	他五	弄得七零八散；揭穿、泄露；杀死
腹立たしい	はらだたしい	形	令人气愤
ばらつく	ばらつく	自五	（雨等）稀稀拉拉地降下；不平均、有偏差
はらはら	はらはら	副，サ変	眼泪、树叶等飘落的样子；非常担心的样子
ばらばら	ばらばら	副，形動	（雨点等）连续降落声；支离破碎
孕む	はらむ	他五	怀孕；鼓起；包含、包藏
腸	はらわた	名	肠；瓜瓤；心地、心肠
波瀾	はらん	名	波澜；纠纷
針	はり	名	缝衣针；刺、钩子
鍼	はり	名	针灸
張り	はり	名	有力；劲头、信心
梁	はり	名	房梁、横梁
張り合う	はりあう	自他五	竞争、抗争；争夺（恋人等）
張り切る	はりきる	自五	拉紧、绷紧；鼓足干劲
張り子	はりこ	名	纸糊的
張り出す	はりだす	自他五	突出、伸出；公布、揭示
春	はる	名	春天；新年；最盛期；青春期
張る	はる	自他五	拉、张开；（将液体）装满；设置、摆；固执、坚持（己见）；打（头、脸）、殴打；胀、僵硬；拉紧；突出来；伸展、扩张
貼る	はる	他五	粘贴
遥か	はるか	副，形動	（在空间、时间、程度上）远、遥远
春雨	はるさめ	名	春雨；粉丝
遥遥	はるばる	副	相隔很远、万里迢迢
春めく	はるめく	自五	有春色、有春意
晴れ	はれ	名	晴、晴天；隆重、正式、公开；（嫌疑）消除
晴れ着	はれぎ	名	盛装
晴れ姿	はれすがた	名	身穿礼服；出席盛大场面的姿态
破裂	はれつ	名，サ変	破裂；显露、爆发；（商谈等）破裂
晴れ晴れ	はればれ	副，サ変	晴朗；愉快、高兴
腫れ物	はれもの	名	肿包、疙瘩
晴れやか	はれやか	形動	晴朗、明朗；心情舒畅；盛大
腫れる	はれる	自下一	肿
晴れる	はれる	自下一	晴；（心情）舒畅；（嫌疑、疑惑）消除
破廉恥	はれんち	形動	厚颜无耻
半	はん	名	半、二分之一
反	はん	接頭	（接名次前）反
範囲	はんい	名	范围
反映	はんえい	名，サ変	反射、反照；反映
繁栄	はんえい	名，サ変	繁荣
繁華	はんか	名，形動	繁华
版画	はんが	名	版画
挽回	ばんかい	名，サ変	挽回
反感	はんかん	名	反感
反逆	はんぎゃく	名，サ変	叛逆
反響	はんきょう	名，サ変	回声、回音；反响，反应
半径	はんけい	名	半径
判決	はんけつ	名，サ変	判决
版権	はんけん	名	版权
判子	はんこ	名	图章
反抗	はんこう	名，サ変	反抗
反攻	はんこう	名，サ変	反攻
犯行	はんこう	名	犯罪行为
番号	ばんごう	名	号码
犯罪	はんざい	名	犯罪行为
万歳	ばんざい	名，サ変	万岁；可喜、可贺；无可奈何
煩雑	はんざつ	名，形動	烦杂、麻烦
万事	ばんじ	名	万事
反射	はんしゃ	名，サ変	反射；折射
晩酌	ばんしゃく	名，サ変	晚酌、晚饭时喝酒
繁盛	はんじょう	名，サ変	繁荣、昌盛
繁殖	はんしょく	名，サ変	繁殖
反する	はんする	サ変	反对、相反；违反
判ずる	はんずる	サ変	判断、推测
反省	はんせい	名，サ変	反省
半生	はんせい	名	半生
万全	ばんぜん	名	完全、万无一失
反訴	はんそ	名，サ変	反诉、反告
伴奏	ばんそう	名，サ変	伴奏
反則	はんそく	名，サ変	犯规、违章
反対	はんたい	名，サ変	相反、相对；反对
判断	はんだん	名，サ変	判断；占卦
番地	ばんち	名	门牌号
範疇	はんちゅう	名	范畴
番付	ばんづけ	名	排名榜
判定	はんてい	名，サ変	判定
半纏	はんてん	名	一种不带翻领的日本短外衣
斑点	はんてん	名	斑点
反騰	はんとう	名，サ変	（行情）回升
反動	はんどう	名	反作用；反动
犯人	はんにん	名	犯人
反応	はんのう	名，サ変	（化学）反应；反响、效果
万能	ばんのう	名	全能；万能
半端	はんぱ	名，形動	不齐全、零星；不彻底、下不了决心
販売	はんばい	名，サ変	贩卖、出售
反発	はんぱつ	名，サ変	回跳、反抗
頒布	はんぷ	名，サ変	颁布、分发
半分	はんぶん	名	二分之一；一半；半……
判明	はんめい	名，サ変	判明、弄清
反面	はんめん	名	反面；另一面
半面	はんめん	名	半面；片面；另一方面
反乱，叛乱	はんらん	名，サ変	叛乱
氾濫	はんらん	名，サ変	（河水）泛滥；充斥、泛滥
凡例	はんれい	名	凡例
販路	はんろ	名	销路
反論	はんろん	名，サ変	反驳、反论
火，灯	ひ	名	火、火焰；灯火、灯光
日	ひ	名	太阳；白昼、白天；一昼夜；（特定的）一天、日子；时期、时代；日期、期限；时候
非	ひ	名，形動，接頭	非、部队；过错、错误；（接在名词形容动词后）非、不是
美	び	名	美；美好
微	び	名，接頭	细微、微笑；（接头）极少
悲哀	ひあい	名	悲哀
干上がる	ひあがる	自五	干透、干涸；无法生活
日当たり	ひあたり	名	向阳（处）
贔屓	ひいき	名，サ変	照顾、偏袒、偏爱
延いては	ひいては	副	进而、进一步
秀でる	ひいでる	自下一	优秀、擅长
冷え込む	ひえこむ	自五	气温骤降；（身体）觉冷、着凉
冷える	ひえる	自下一	变冷、变凉；（感情等）变冷淡
鼻炎	びえん	名	鼻炎
被害	ひがい	名	被害、遭灾
控えめ	ひかえめ	名，形動	节制；谨慎、客气
日帰り	ひがえり	名，サ変	当天回来
控える	ひかえる	自他下一	（在近旁）等候；拉住、拽住；节制、控制；面临、靠近；写下来
比較	ひかく	名，サ変	比较
皮革	ひかく	名	皮革
非核	ひかく	名	非核
日陰	ひかげ	名	背阴的地方；见不得人、不得见闻于世
日傘	ひがさ	名	太阳伞
東	ひがし	名	东
僻む	ひがむ	自五	乖僻、抱偏见
干からびる	ひからびる	自上一	干透、干巴巴
光	ひかり	名	光、光亮；势力、威力；光明、希望
光る	ひかる	自五	发光、闪光；出众、显眼
引かれる	ひかれる	自下一	被吸引
悲観	ひかん	名，サ変	悲观
彼岸	ひがん	名	涅磐之后的境界、彼岸（佛）；春分、秋分前后各加三天共七天的期间
悲願	ひがん	名	（佛）（佛、菩萨）大慈大悲的誓愿；悲壮的誓愿、势必实现的誓愿
悲喜	ひき	名	悲喜
引き上げる	ひきあげる	他下一	打捞、吊起；提高、涨价；提升、提拔；撤回、撤走；返回
率いる	ひきいる	他上一	率领、统率
引き受ける	ひきうける	他下一	承担、接受；保证
引き返す	ひきかえす	自五	返回
引き換える	ひきかえる	他下一	交换、兑换；相反、不同
蟾蜍	ひきがえる	名	蟾蜍
引き込む	ひきこむ	自他五	引进来；患（伤风、感冒）
引きこもる	ひきこもる	自五	闷居家中
引き締まる	ひきしまる	自五	绷紧、紧张
引き締める	ひきしめる	他下一	勒紧、拉紧；使（精神等）紧张；紧缩、节俭
引き摺る	ひきずる	他五	拖、拽；硬拉；拖延
引出し	ひきだし	名	抽屉
引き出す	ひきだす	他五	拉出、发挥；提出、提取（存款）
引き立つ	ひきたつ	自五	显眼
引き立てる	ひきたてる	他下一	强行拉走；关闭（拉门）；鼓励；关照；衬托、使……显得好看
引き続き	ひきつづき	副	继续
引き攣る	ひきつる	自五	（烧、烫伤等）结伤疤；痉挛、抽筋；僵硬、发僵
引き止める	ひきとめる	他下一	留、挽留
引き取る	ひきとる	自他五	领取、领回；收养；死；退出、离去
挽肉	ひきにく	名	肉末
引き抜く	ひきぬく	他五	拔出；拉拢过来
引き伸ばす	ひきのばす	他五	拉长、抻长；（相片）放大
引き延ばす	ひきのばす	他五	延长、拖长
卑怯	ひきょう	名，形動	懦弱、卑鄙
卑近	ひきん	名，形動	浅近、浅显
引く	ひく	他自五	拉、拽；拔出、抽（签）；收回、缩回；搭拉、拖；引导、领；消减、扣除；引进、安装（电灯、自来水等）；划线；拉长；涂上；吸引、引诱；作用；查（字典等）；继承；吸入、进入体内；消退、减退；后退；辞去、退出
碾く	ひく	他五	磨碎
轢く	ひく	自五	碾、压
弾く	ひく	他五	弹奏、拉
低い	ひくい	形	低、矮；低贱；低微
卑屈	ひくつ	名，形動	卑躬屈膝
びくとも	びくとも	副	（下接否定语）一动不动、处之泰然
比丘尼	びくに	名	尼姑
びくびく	びくびく	副，サ変	（吓得）发抖、提心吊胆
低める	ひくめる	他下一	降低
日暮れ	ひぐれ	名	日暮、黄昏
卑下	ひげ	名，サ変	自卑
髭	ひげ	名	胡须；（动物的）须
悲劇	ひげき	名	（戏剧）悲剧
否決	ひけつ	名，サ変	否决
秘訣	ひけつ	名	秘诀
引け目	ひけめ	名	自卑感
ひけらかす	ひけらかす	他五	炫耀、夸耀
引ける	ひける	自下一	不好意思、畏缩
退ける	ひける	自下一	下班、放学
比肩	ひけん	名，サ変	匹敌
非行	ひこう	名	不良行为
備考	びこう	名	备考
尾行	びこう	名，サ変	尾随、盯梢
被告	ひこく	名	被告
日ごと	ひごと	名	每天；日渐
日頃	ひごろ	名，副	平素、平时
膝	ひざ	名	膝盖；大腿
被災	ひさい	名，サ変	受灾
微細	びさい	名，形動	微细
日差し	ひざし	名	阳光照射、照射的阳光
久しい	ひさしい	形	好久、许久
久し振り	ひさしぶり	名，形動	（隔了）好久
跪く	ひざまずく	自五	跪、跪下
氷雨	ひさめ	名	冷雨；雹
悲惨	ひさん	名，形動	悲惨
菱	ひし	名	菱、菱角
肘	ひじ	名	肘、臂肘
肘鉄砲	ひじでっぽう	名	用胳膊肘撞人；严厉拒绝
びしびし	びしびし	副	严厉、不留情
犇く	ひしめく	自五	（人群）拥挤、吵吵嚷嚷
比重	ひじゅう	名	比重；（所占的）比例、对比
美術	びじゅつ	名	美术
批准	ひじゅん	名，サ変	批准
秘書	ひしょ	名	秘书
避暑	ひしょ	名，サ変	避暑
非常	ひじょう	名，形動	非常；紧急；极、很
非情	ひじょう	形動	无情、冷酷
微笑	びしょう	名，サ変	微笑
非常勤	ひじょうきん	名	定期出勤、特邀
非常識	ひじょうしき	名，形動	没有常识、不合乎情理
美食	びしょく	名，サ変	美食
びしょ濡れ	びしょぬれ	名	湿透、淋湿
びしょびしょ	びしょびしょ	副，形動	（雨）连绵不断；湿透、湿淋淋地
美人	びじん	名	美人、美女
翡翠	ひすい	名	翡翠；翡翠（鸟）
歪み	ひずみ	名	斜、歪；（喻）不良影响；（心地）不正；变形
微生物	びせいぶつ	名	微生物
秘蔵	ひぞう	名，サ変	珍藏；珍爱
密か	ひそか	形動	秘密、偷偷、暗中
卑俗	ひぞく	名，形動	粗俗、下流
潜む	ひそむ	自五	隐藏；藏在（心中）
潜める	ひそめる	他下一	隐藏；消（声）
襞	ひだ	名	（衣服等的）褶；褶皱
額	ひたい	名	额
浸す	ひたす	他五	浸泡；浸湿
只管	ひたすら	副	一味、一个劲地
肥立ち	ひだち	名	康复；成长
左	ひだり	名	左；左翼
左団扇	ひだりうちわ	名	安闲度日
浸る	ひたる	自五	浸、淹；沉浸在、耽于
美談	びだん	名	美谈
美男子	びだんし	名	美男子
筆	ひつ	名	笔；笔迹
悲痛	ひつう	形動	悲痛
引っかかる	ひっかかる	自五	挂住；牵连；上当；挂心
引っ掛ける	ひっかける	他下一	挂上、剐破；披上；泼上、溅上；欺骗；（一口气）喝；撞上
筆記	ひっき	名，サ変	记笔记、笔记
柩	ひつぎ	名	棺、柩
畢竟	ひっきょう	副	毕竟、结局
引っ切り無し	ひっきりなし	形動	接连不断地、不停地
びっくり	びっくり	副，サ変	吃惊
ひっくり返る	ひっくりかえる	自五	颠倒过来；倒下、翻倒；被推翻
引っ括める	ひっくるめる	他下一	汇总起来
火付け役	ひつけやく	名	放活者；肇事者
日付	ひづけ	名	（记载文件等制成、提出）年月日、日期
跛	びっこ	名	瘸子、不成双
引っ越す	ひっこす	他五	搬家、迁居
引っ込む	ひっこむ	自五	引退；塌陷，洼下；退下、退出
必死	ひっし	名，形動	拼命、殊死
羊	ひつじ	名	羊
筆者	ひっしゃ	名	作者
必修	ひっしゅう	名	必修
必勝	ひっしょう	名	必胜
びっしょり	びっしょり	副	湿透
びっしり	びっしり	副	挤得紧紧、密密麻麻
必然	ひつぜん	名	必然
ひっそり	ひっそり	副，サ変	寂静、鸦雀无声
ぴったり	ぴったり	副，形動	紧紧地；恰好、正合适；说中、猜中
匹敵	ひってき	名，サ変	匹敌
逼迫	ひっぱく	名，サ変	困窘、紧迫
引っ張る	ひっぱる	他五	（用力）拉、拽硬拉走
蹄	ひづめ	名	蹄
必要	ひつよう	名，形動	必要、必需、需要
否定	ひてい	名，サ変	否定
日照，旱	ひでり	名	太阳（强烈）照射、干旱；不足、缺乏
秘伝	ひでん	名	秘传
人	ひと	名	人、人类；个人；成人；人品；他人；人手
一	ひと	数	一、一个、一回；整个、全
酷い	ひどい	形	残酷、无情；厉害、严重
一息	ひといき	名	一口气、歇一口气；一鼓作气、一股劲儿；（再加）一把劲
人一倍	ひといちばい	名，副	比别人加倍
一重	ひとえ	名	一重、一层、单
偏に	ひとえに	副	完全、专心
人影	ひとかげ	名	人影；身姿、身影
一方	ひとかた	名	（下接否定语）一般、普通
人柄	ひとがら	名	人品、品质；人品好
一際	ひときわ	副	格外、尤其
秘匿	ひとく	名，サ変	隐藏
美徳	びとく	名	美德
一口	ひとくち	名	一口；（吃、喝）一点；一句（话）；（入股、捐款等）一股、一份
人気	ひとけ	名	人的声息、象有人的样子
人恋しい	ひとこいしい	形	想与人交际的
一言	ひとこと	名	一句话；只言片语
人事	ひとごと	名	旁人的事；别人的事
人込み	ひとごみ	名	人群拥挤（的地方）
人差し指	ひとさしゆび	名	食指
等しい	ひとしい	形	相等、相同；类似于、近似于
一入	ひとしお	副	格外、越发
一筋	ひとすじ	名，副	一条、一道；一心一意
一つ	ひとつ	名，副	一个、一岁；表示强调；一体、一样；一方面；试一试、稍微；请
一つ覚え	ひとつおぼえ	名	老记住一件事、老一套
人手	ひとで	名	人工；旁人的手；人员、人手
人出	ひとで	名	很多人聚集到一个地方、外出的人群
一通り	ひととおり	副	大概、大略；一般、普通
一時	ひととき	名	一会儿；曾经有个时候
人波	ひとなみ	名	人潮
人並み	ひとなみ	名，形動	普通、与常人同样、平常
一握り	ひとにぎり	名	少数、一小撮
人々	ひとびと	名	人们、许多人
人真似	ひとまね	名，サ変	学人、模仿别人；（动物）模仿人
瞳	ひとみ	名	瞳孔；眼睛
人見知り	ひとみしり	名，サ変	（小孩）认生
一昔	ひとむかし	名	往昔、过去（一般指十年左右以前）
人目	ひとめ	名	世人眼目、旁人看见
一目	ひとめ	名	看一眼；一眼看穿
一役	ひとやく	名	一项任务
人好	ひとよし	名	大好人、老好人
一人，独り	ひとり	名，副	一个人；独身；独自；（后接否定）仅仅、只是
日取り	ひどり	名	日期、日程
独り合点	ひとりがてん	名，サ変	自以为懂、自以为是
独り言	ひとりごと	名	自言自语
一人っ子	ひとりっこ	名	独生子
独りでに	ひとりでに	副	自然而言、自动地
独り善がり	ひとりよがり	名，形動	自命不凡、自以为是
雛	ひな	名	雏鸡；偶人儿、泥人儿；（接头）小、巧
日向	ひなた	名	向阳（的地方）；顺境
雛人形	ひなにんぎょう	名	（日本三月三日女孩节系列的）偶人
鄙びる	ひなびる	自上一	土气、带有乡村风味
雛祭り	ひなまつり	名	日本三月三日女孩节系列偶人的节日活动
非難	ひなん	名，サ変	非难
避難	ひなん	名，サ変	避难
皮肉	ひにく	形動	挖苦、讽刺；不如意、不凑巧
皮肉る	ひにくる	他五	挖苦、奚落、讽刺
否認	ひにん	名，サ変	否认
捻くる	ひねくる	他五	玩弄、摆弄；找借口辩解；玩味
捻くれる	ひねくれる	自下一	弯曲、扭歪乖僻、别扭
終日	ひねもす	名	终日
捻る	ひねる	他五	扭转（身体等）；捻、拧、扭；费尽心机；（轻而易举）打败
檜	ひのき	名	日本扁柏
日の出	ひので	名	日出；旭日喷薄（之势）
日の丸	ひのまる	名	红太阳形；（日本国旗）太阳旗
被爆	ひばく	名，サ変	被炸、遭受轰炸；被原子弹轰炸、遭受放射能的灾害
火花	ひばな	名	火星；（电）火花
雲雀	ひばり	名	云雀
批判	ひはん	名，サ変	评论；批评、批判
日日	ひび	名	每天
皹	ひび	名	龟裂、皴裂
罅	ひび	名	裂纹、裂痕；（亲密关系）发生裂痕
響き	ひびき	名	回声、响声；影响；听到时的感觉
響く	ひびく	自五	发出回音、有回响；震动；影响；扬名、闻名
批評	ひひょう	名，サ変	评价、评论
備品	びひん	名	设备、装置
皮膚	ひふ	名	皮肤
疲弊	ひへい	名，サ変	疲惫；（国力、经济等）疲惫、萧条
備忘	びぼう	名	备忘
非凡	ひぼん	名，形動	非凡
暇	ひま	名，形動	时间；闲暇、闲工夫；休假；解雇；离婚
向日葵	ひまわり	名	向日葵
肥満	ひまん	名，サ変	肥胖
秘密	ひみつ	名	秘密
微妙	びみょう	名，形動	微妙
姫	ひめ	名，接頭	女子的美称；贵族小姐、闺秀；表示小而可爱之意
悲鳴	ひめい	名	悲鸣、惊叫；叫苦
秘める	ひめる	他下一	隐藏、隐秘；蕴藏、蕴含
罷免	ひめん	名，サ変	罢免、免职
紐	ひも	名	带、细绳；（暗中操纵的）条件；（得倒贴的、妓女等的）情夫
日持ち	ひもち	名	（食物等的）耐存程度、能放得住
紐解く，繙く	ひもとく	他五	翻阅、阅读
干物	ひもの	名	晒干的鱼、贝类
冷や	ひや	名	凉、冷
冷やかす	ひやかす	他五	挖苦、嘲弄、奚落；只问价不买
飛躍	ひやく	名，サ変	跳跃；飞跃、跃进
百	ひゃく	名	一百；许多；百岁
百姓	ひゃくしょう	名	百姓、农民
白檀	びゃくだん	名	白檀、檀香
百聞	ひゃくぶん	名	反复听说
日焼け	ひやけ	名，サ変	晒黑
冷やす	ひやす	他五	凉一凉、（用冰）镇、使冷静
百貨	ひゃっか	名	百货
冷ややか	ひややか	形動	凉、冷；冷淡
比喩	ひゆ	名	比喻
費用	ひよう	名	费用
美容	びよう	名	美容
病院	びょういん	名	医院
表音	ひょうおん	名	注音、标音
評価	ひょうか	名，サ変	定价、评价；（好的）评定
表記	ひょうき	名，サ変	表面记载（的东西）；（用文字、符号等）记载
病気	びょうき	名	病；老毛病、恶习
ひょうきん	ひょうきん	形動	轻佻、滑稽
表敬	ひょうけい	名	表示敬意
氷結	ひょうけつ	名，サ変	结冰
表決	ひょうけつ	名，サ変	表决
表現	ひょうげん	名，サ変	表现、表达
標高	ひょうこう	名	海拔
氷山	ひょうざん	名	冰山
拍子	ひょうし	名	拍、节拍；一刹那、一……时候
表紙	ひょうし	名	封面、封皮
表示	ひょうじ	名，サ変	表达、表示；（用图表）表示
標識	ひょうしき	名	标志、标示
描写	びょうしゃ	名，サ変	描写
病弱	びょうじゃく	名，形動	病弱
標準	ひょうじゅん	名	基准；普通、平均
表彰	ひょうしょう	名，サ変	表彰
表情	ひょうじょう	名	表情；情况
病状	びょうじょう	名	病状、病情
表する	ひょうする	サ変	表示
評する	ひょうする	サ変	评论、评价
氷雪	ひょうせつ	名	冰雪
剽窃	ひょうせつ	名，サ変	剽窃
飄然	ひょうぜん	形動	突然（来去）、飘忽不定、飘然
表層	ひょうそう	名	表层
瓢箪	ひょうたん	名	葫芦、酒葫芦
評定	ひょうてい	名，サ変	评定
氷点	ひょうてん	名	冰点、（摄氏）零度
平等	びょうどう	名，形動	平等
病人	びょうにん	名	病人、患者
漂泊	ひょうはく	名，サ変	漂泊、流浪
漂白	ひょうはく	名，サ変	漂白
評判	ひょうばん	名	评价、传闻；闻名、出名
屏風	びょうぶ	名	屏风
病弊	びょうへい	名	弊病
豹変	ひょうへん	名，サ変	突然改变
標榜	ひょうぼう	名，サ変	标榜
病没	びょうぼつ	名，サ変	病故
標本	ひょうほん	名	标本；样本；典型
表明	ひょうめい	名，サ変	表明
表面	ひょうめん	名	表面；外观、外表
表裏	ひょうり	名	表里；（表里）不一致
漂流	ひょうりゅう	名，サ変	漂流
評論	ひょうろん	名，サ変	评论
肥沃	ひよく	名，形動	肥沃
日除け	ひよけ	名	遮日、遮日光的东西
雛	ひよこ	名	幼鸟，鸡雏；黄口小儿、小毛孩
ひょっと	ひょっと	副	突然、偶然；不留神
日和	ひより	名	天气；晴天；趋势、形势
日和見	ひよりみ	名	天气预测；观望形势
平	ひら	名，接頭	普通、一般人；（接在名词之前）平的；（接在含有动作性的词语之前）一个劲地、一味地
平仮名	ひらがな	名	平假名
開き	ひらき	名	差距；散会、结束；（剖开鱼腹的）干鱼
開き直る	ひらきなおる	自五	突然改变态度
開く	ひらく	自他五	开启、敞开；打开；（割る）（砕く）等词的避讳说法；（数学）开方；开始；开；开花；有差距
拓く	ひらく	他五	开拓
開ける	ひらける	自下一	舒展、开阔；开化；开明
平たい	ひらたい	形	平的、平坦的；浅显易懂的
ひらひら	ひらひら	副，サ変	飘扬、飘荡
比目魚	ひらめ	名	比目鱼
閃かす	ひらめかす	他五	使闪闪发光；显示、夸示（才能等）
閃き	ひらめき	名	闪光；（才能、感觉等）闪现
閃く	ひらめく	自五	闪耀、闪烁；飘动；闪现、突然想出
ひらりと	ひらりと	副	（身体）轻巧地、敏捷地
比率	ひりつ	名	比率
ひりひり	ひりひり	副，サ変	辣得荒、火辣辣地疼
微粒子	びりゅうし	名	微粒子
肥料	ひりょう	名	肥料
微量	びりょう	名	微量
微力	びりょく	名	力量微薄、（谦）微力
昼	ひる	名	白天、白昼；中午、正午；午饭
蛭	ひる	名	水蛭、蚂蟥
比類	ひるい	名	相比
翻す	ひるがえす	他五	翻过来；翻身一跃；使飘扬；突然改变态度
昼間	ひるま	名	白天、白昼
怯む	ひるむ	自五	畏怯、胆怯
鰭	ひれ	名	鳍
比例	ひれい	名，サ変	比例；成比例关系
非礼	ひれい	名，形動	非礼、失礼
披瀝	ひれき	名，サ変	吐露、表露
卑劣	ひれつ	名，形動	卑劣
平伏す	ひれふす	自五	跪拜、叩拜
広い	ひろい	形	辽阔；渊博的、广泛的；（心胸）宽广
拾う	ひろう	他五	拾、捡；挑、选；意外得到；在路上雇（汽车等）
披露	ひろう	名，サ変	公布、发表；披露、宣布
疲労	ひろう	名，サ変	疲劳；磨损
広がる	ひろがる	自五	（面积、范围）扩大、蔓延；拡大、拡展
広げる	ひろげる	他下一	打开、展开；扩大、扩展
広場	ひろば	名	广场；（喻）场所
広広	ひろびろ	副，サ変	辽阔；宽广
広間	ひろま	名	客厅、大厅
広まる	ひろまる	自五	传播、扩散
広める	ひろめる	他下一	扩大；普及、推广
秘話	ひわ	名	秘史、秘密故事
枇杷	びわ	名	枇杷
琵琶	びわ	名	琵琶
卑猥	ひわい	形動	下流、粗鄙
日割り	ひわり	名	按日计算（工资）；日程表
干割れる	ひわれる	自下一	干裂
品	ひん	名	物品、东西；品格
便	びん	名	邮寄；交通运输设施、班车、班机；机会、方便
品位	ひんい	名	品格；矿石的含矿量、（金银的）成色
品格	ひんかく	名	品格、人格
敏活	びんかつ	形動	敏捷、灵敏
敏感	びんかん	名，形動	敏感
貧窮	ひんきゅう	名，サ変	贫困、贫苦
貧血	ひんけつ	名，サ変	贫血
品行	ひんこう	名	品行
貧困	ひんこん	名，形動	贫困；（知识、思想等的）贫乏
品詞	ひんし	名	品词、词类
瀕死	ひんし	名	濒死
品質	ひんしつ	名	品质
貧弱	ひんじゃく	名，形動	贫乏；逊色、寒碜
品種	ひんしゅ	名	种类、品种
顰蹙	ひんしゅく	名	皱眉
頻出	ひんしゅつ	名，サ変	层出不穷
敏捷	びんしょう	名，形動	敏捷
便乗	びんじょう	名，サ変	就便搭乘（车船等）；趁机利用
瀕する	ひんする	サ変	濒临、迫近
便箋	びんせん	名	信纸
びんた	びんた	名	嘴巴、耳光
頻度	ひんど	名	频度、频率
頻発	ひんぱつ	名，サ変	屡次发生
頻繁	ひんぱん	形動	频繁
貧富	ひんぷ	名	贫富
貧乏	びんぼう	名，形動，サ変	贫困、贫穷
品目	ひんもく	名	品种
ひんやり	ひんやり	副，サ変	凉嗖嗖的
不	ふ	接頭	不；没有、不好
歩合	ぶあい	名	比率；手续费、佣金
無愛想	ぶあいそう	名，形動	冷淡
分厚い	ぶあつい	形	非常厚
不安	ふあん	名，形動	不安、担心
不安定	ふあんてい	名，形動	不安定
不意	ふい	名，形動	突然、意外
吹聴	ふいちょう	名，サ変	吹嘘
風	ふう	名，接尾	分；样式；倾向；状态
風雨	ふうう	名	风雨；暴风雨
風雲	ふううん	名	风云；形势、时局
風化	ふうか	名，サ変	（地质）风化；（喻）（记忆）淡薄
風格	ふうかく	名	风采、品格
風変わり	ふうがわり	名，形動	与众不同、古怪
富貴	ふうき	名，形動	富贵
封切り	ふうきり	名	刚开封的东西；开始；首次放映
風景	ふうけい	名	风景、情景
封鎖	ふうさ	名，サ変	封锁
風刺，諷刺	ふうし	名，サ変	讽刺
風習	ふうしゅう	名	习惯
封ずる	ふうずる	サ変	封上；封闭；禁止
風船	ふうせん	名	气球
風速	ふうそく	名	风速
風俗	ふうぞく	名	风俗；风纪
瘋癲	ふうてん	名	疯癫、精神病；四处漂泊的人
風土	ふうど	名	风土、水土
封筒	ふうとう	名	信封
風評	ふうひょう	名	传说、谣传
夫婦	ふうふ	名	夫妇
ふうふう	ふうふう	副	呼哧呼哧地；忙得喘不过气来
風物	ふうぶつ	名	景色、风景
風来坊	ふうらいぼう	名	来去无踪的人、无定性的人
風流	ふうりゅう	名，形動	风流、风雅
不運	ふうん	名，形動	不幸
笛	ふえ	名	笛子
不得手	ふえて	名，形動	不善长、不喜好
増える，殖える	ふえる	自下一	增加、增多
敷衍	ふえん	名，サ変	详述、细说
無遠慮	ぶえんりょ	名，形動	不客气、不拘束
不可	ふか	名	不可、不行；不合格
付加，附加	ふか	名，サ変	附加
部下	ぶか	名	部下
深い	ふかい	形	深；深刻、深远；深厚；（色、香）浓、深
不快	ふかい	名，形動	不愉快；患病
不甲斐無い，不甲斐ない	ふがいない	形x	没有志气、窝囊
不覚	ふかく	名，形動	失策；不知不觉；失去知觉
不可欠	ふかけつ	名，形動	不可少的、必需的
更かす	ふかす	他五	熬夜
蒸かす	ふかす	他五	蒸
吹かす	ふかす	他五	喷烟、吸烟；（使发动机）高速运转；逞威风、摆（架子）
深深と	ふかぶかと	副	深深地
深まる	ふかまる	自五	深起来、深化
深み	ふかみ	名	深处；与……关系紧密；深度
深める	ふかめる	他下一	加深、加强
俯瞰	ふかん	名，サ変	俯瞰
付記	ふき	名，サ変	附记、附注
武器	ぶき	名	武器；（喻）有力的手段、武器
吹き替える	ふきかえる	他下一	（货币、金属）重铸；代演、替角；（外国电影、电视等）译制、配音
不機嫌	ふきげん	名，形動	不愉快
吹き込む	ふきこむ	自他五	刮尽；教唆、灌输；录音
吹き出す，噴き出す	ふきだす	自五	冒出、喷出；噗地笑起来
不吉	ふきつ	名，形動	不吉利
吹き付ける	ふきつける	自他下一	风劲吹；喷上
吹き出物	ふきでもの	名	肿疱；疙瘩
吹き飛ばす	ふきとばす	他五	刮跑；驱除、驱散
吹き回し	ふきまわし	名	风向；当时的心情、情况
不気味	ぶきみ	形動	令人不快的
不朽	ふきゅう	名	不朽
普及	ふきゅう	名，サ変	普及
不況	ふきょう	名	不景气
布教	ふきょう	名，サ変	传道
不器用	ぶきよう	名，形動	笨拙、不灵巧
付近	ふきん	名	附近
布巾	ふきん	名	擦碗布
服	ふく	名	衣服
福	ふく	名	福、幸福
副	ふく	名，接頭	副的；副件
拭く	ふく	他五	擦、试
吹く	ふく	自他五	刮；吹；吹（笛等）；吹牛；铸造
噴く	ふく	自五	（水蒸气等）喷出；（向外部）现出、冒出
葺く	ふく	他五	修葺（屋顶）
河豚	ふぐ	名	河豚
不遇	ふぐう	名，形動	境遇不佳、不得志
服役	ふくえき	名，サ変	（犯人）服劳役、服兵役
副業	ふくぎょう	名	副业
復元，復原	ふくげん	名，サ変	复原、恢复原状
複合	ふくごう	名，サ変	复合
複雑	ふくざつ	名，形動	复杂
副作用	ふくさよう	名	副作用
副詞	ふくし	名	副词
福祉	ふくし	名	福利
複写	ふくしゃ	名，サ変	誊写、复写；复印、复制
輻射	ふくしゃ	名，サ変	辐射
復習	ふくしゅう	名，サ変	复习
復讐	ふくしゅう	名，サ変	复仇
服従	ふくじゅう	名，サ変	服从
服飾	ふくしょく	名，サ変	服饰
覆水盆に返らず	ふくすいぼんにかえらず	連語	覆水难收
複数	ふくすう	名	复数；（语）复数
服する	ふくする	サ変	服从；服务、从事；服用（茶等）
複製	ふくせい	名，サ変	复制、仿制
伏線	ふくせん	名	伏笔
服装	ふくそう	名	服装
不倶戴天	ふぐたいてん	名	不共戴天
腹痛	ふくつう	名	腹痛
福引	ふくびき	名	抽签、抽彩
福福しい	ふくぶくしい	形	胖乎乎、有福
含み	ふくみ	名	包含、含有；含蓄、暗示
含む	ふくむ	他五	含有；含着；怀有（想法、感情等）；带、含；包括
服務	ふくむ	名，サ変	服务、工作
含める	ふくめる	他下一	包含、包括；告知、嘱咐
服喪	ふくも	名，サ変	服丧
服用	ふくよう	名，サ変	服药
膨よか	ふくよか	形動	丰满、鼓起、松软
膨らむ	ふくらむ	自五	鼓起、膨胀；（想法、计划的规模）拡大
福利	ふくり	名	福利
膨れっ面	ふくれっつら	名	（因生气、不满而）噘着嘴的脸
膨れる	ふくれる	自下一	肿、胀、鼓出；生气、不高兴
袋	ふくろ	名	口袋；水果的内皮
梟	ふくろう	名	猫头鹰、枭；比喻夜间活动的人
雲脂，頭垢	ふけ	名	头发、头垢
武家	ぶけ	名	武士、武士门第（人）
不敬	ふけい	名，形動	（对皇室、神社等的）不敬、无礼
父兄	ふけい	名	父兄；家长
不景気	ふけいき	名，形動	不景气、萧条；无精打采
不潔	ふけつ	名，形動	不干净、脏
更ける	ふける	自下一	（季节、叶）深
老ける	ふける	自下一	老、上年纪
不孝	ふこう	名，形動	不孝
不幸	ふこう	名，形動	不幸；（家人、亲属的）死亡、丧事
符号	ふごう	名	符号、记号；电码、代码；（数）符号
負号	ふごう	名	负号
不公平	ふこうへい	名，形動	不公平
布告	ふこく	名，サ変	布告、公告；宣布、宣告
房	ふさ	名	一束；一串、一挂、一嘟噜
夫妻	ふさい	名	夫妻
負債	ふさい	名	负债
不在	ふざい	名	不在、不在家
不細工	ぶさいく	名，形動	拙笨、不灵巧；丑、难看
塞がる	ふさがる	自五	塞满、占满；关、闭；占着、用着
塞ぎ	ふさぎ	名	精神郁闷
不作	ふさく	名	歉收、年成不好；（作品等）质量不好
塞ぐ	ふさぐ	自他五	挡、阻挡；（耳朵）堵、塞；郁闷、不舒畅
ふざける	ふざける	自下一	欢闹、欢蹦乱跳；开玩笑；愚弄、戏弄；（男女间）调情
無沙汰	ぶさた	名，サ変	久疏问候、久未通信
無作法	ぶさほう	名，形動	没礼貌、粗野
相応しい	ふさわしい	形	适合、相称
節	ふし	名	节、关节；曲调、旋律；段落；地方、点
藤	ふじ	名	紫藤；淡紫色
不治	ふじ	名	不能医治
武士	ぶし	名	武士
無事	ぶじ	名，形動	健康；平安、太平无事
不思議	ふしぎ	名，形動	不可思议、奇怪
不自然	ふしぜん	名，形動	不自然
ふしだら	ふしだら	名，形動	放荡、行为不检点
部室	ぶしつ	名	俱乐部活动用的房间
節節	ふしぶし	名	各个关节；各点、许多地方
節回し	ふしまわし	名	曲调、旋律
節目	ふしめ	名	节眼；阶段、段落
伏目	ふしめ	名	低头、眼睛朝下看
不自由	ふじゆう	名，形動	不自由、不如意、不充裕；不好使
不十分	ふじゅうぶん	名，形動	不充分、不完全
武術	ぶじゅつ	名	武术
不純	ふじゅん	名，形動	不纯
不順	ふじゅん	名，形動	不顺、不正常
婦女	ふじょ	名	妇女、女子
扶助	ふじょ	名，サ変	扶助、帮助
部署	ぶしょ	名	部署、工作岗位、职守
不肖	ふしょう	名，代	不肖；（谦）鄙人、不才
不詳	ふしょう	名，形動	不详、不清楚
不祥	ふしょう	名，形動	不祥、不吉利、不幸
負傷	ふしょう	名，サ変	负伤、受伤
不精	ぶしょう	名，サ変	懒、怠惰
武将	ぶしょう	名	武将
不承不承	ふしょうぶしょう	副，形動	勉强答应
腐食，腐蝕	ふしょく	名，サ変	腐蚀
侮辱	ぶじょく	名，サ変	侮辱
不信	ふしん	名，形動	不信任；没有信仰心；不守信用、不诚实
不審	ふしん	名，形動	怀疑、疑问
不振	ふしん	名，形動	不振、不兴旺
普請	ふしん	名，サ変	建筑、施工、修缮
夫人	ふじん	名	（敬）夫人
婦人	ふじん	名	妇女、女子
付随，附随	ふずい	名，サ変	附带、随着
不随	ふずい	名，サ変	不遂、不自由
負数	ふすう	名	负数
部数	ぶすう	名	（出版物的）部数、册数
襖	ふすま	名	隔扇、拉门
付する，附する	ふする	サ変	附加；提交、交给
布施	ふせ	名	布施、施舍
不正	ふせい	名，形動	不正、不正派、坏行为
風情	ふぜい	名，接尾	情趣、风趣；款待；样子；（表示轻视或自谦）……之类、……的样子
無勢	ぶぜい	名，形動	人少、力量单薄
布石	ふせき	名	（围棋）布局；（喻）准备（的手段）、布置、部署
防ぐ	ふせぐ	他五	防御、防止、预防
敷設	ふせつ	名，サ変	架设、铺设
不摂生	ふせっせい	名，形動	不注意健康、没有节制
臥せる	ふせる	自五	躺、卧、卧床
伏せる	ふせる	他下一	翻（过来）、扣（过来）；向下、伏下；隐藏、埋伏、不张扬
武装	ぶそう	名，サ変	武装
不相応	ふそうおう	名，形動	不相称、不合适
不足	ふそく	名，形動	不足、缺少；不满意
付則，附則	ふそく	名	附则
付属，附属	ふぞく	名，サ変	附属
蓋	ふた	名	盖子、揭晓
札	ふだ	名	牌子、条子；告示牌
豚	ぶた	名	猪
付帯，附帯	ふたい	名，サ変	附带
舞台	ぶたい	名	舞台；活动的场所、舞台
部隊	ぶたい	名	部队；队伍
二重	ふたえ	名	双层、双重
双子	ふたご	名	双生子、双胞胎
再び	ふたたび	副	再次
二つ	ふたつ	名	二、两个；第二；两岁
二股	ふたまた	名	两叉、两股；一心二用、摇摆不定
二人	ふたり	名	两个人
負担	ふたん	名，サ変	承担、负担；重负、累赘
不断	ふだん	副	不断地、经常地；不果断
普段	ふだん	副	平常
縁	ふち	名	边、缘、框
淵	ふち	名	渊、深水处；痛苦的境地、深远
ぶち壊す	ぶちこわす	他五	弄坏、打碎；打乱、破坏
ぶちまける	ぶちまける	他下一	倾倒一空；完全说出、和盘托出
付着，附着	ふちゃく	名，サ変	附着、粘着
不注意	ふちゅうい	名，形動	不注意、不小心
不調	ふちょう	名，形動	不成功、失败；不顺利
部長	ぶちょう	名	部长
浮沈	ふちん	名，サ変	盛衰、变迁
打つ	ぶつ	他五	打；讲演（的强调说法）
普通	ふつう	名，形動	普通、通常；一般
二日	ふつか	名	二日、两天
物価	ぶっか	名	物价
復活	ふっかつ	名，サ変	复活；复兴
ぶつかる	ぶつかる	自五	撞、碰；遇到、碰到；适逢、赶到一起；交涉、直接谈判；冲突、争吵
復旧	ふっきゅう	名，サ変	恢复原状、修复
仏教	ぶっきょう	名	佛教
ぶっきらぼう	ぶっきらぼう	名，形動	粗鲁、莽撞、生硬
ぶつぎり	ぶつぎり	名	（烹饪）切成大块（的鱼肉等）
吹っ切る	ふっきる	他五	（隔阂等）完全消除
ふっくら	ふっくら	副，サ変	柔软而丰满状、松软而鼓起状
ぶつける	ぶつける	他下一	投、扔；撞上、碰上；提出（难题等）
復興	ふっこう	名，サ変	复兴
物産	ぶっさん	名	物产、产品
物資	ぶっし	名	物资
仏事	ぶつじ	名	佛事、法事
物質	ぶっしつ	名	物质
払拭	ふっしょく	名，サ変	消除、肃清
物騒	ぶっそう	名，形動	危险；骚然不安
仏像	ぶつぞう	名	佛像
物体	ぶったい	名	物体
仏頂面	ぶっちょうづら	名	绷着脸、板着脸
不束	ふつつか	形動	不周到、没礼貌、无能、鲁钝
物的	ぶってき	形動	物质的
沸点	ふってん	名	沸点
ふっと	ふっと	副	噗地（吹口气）；忽然、猛地
沸騰	ふっとう	名，サ変	沸腾；白热化、沸腾
吹っ飛ぶ	ふっとぶ	自五	（忽然一下子）刮跑、刮走；花光、化为乌有
物品	ぶっぴん	名	物品、东西
ぶつぶつ	ぶつぶつ	副，名	抱怨、牢骚；许多颗粒状物、许多疙瘩
物欲	ぶつよく	名	物欲
物理	ぶつり	名	物理
筆	ふで	名	毛笔；写的字、画的画、笔迹
不出来	ふでき	名，形動	收成不好、做得不好
不適当	ふてきとう	名，形動	不适当、不恰当
不手際	ふてぎわ	名，形動	不精巧、不漂亮、笨拙
ふてくされる	ふてくされる	自下一	（因不满）怄气、闹情绪
ふてぶてしい	ふてぶてしい	形	毫不客气、目中无人、厚脸皮
不図	ふと	副	突然、偶然
太い	ふとい	形	粗、胖、肥；（声音）粗；脸皮厚、厚颜无耻
ふとう	ふとう	名，形動	不当、不得当
埠頭	ふとう	名	码头
舞踏	ぶとう	名	舞蹈
葡萄	ぶどう	名	葡萄
不動産	ふどうさん	名	不动产
懐	ふところ	名	怀、胸；被环抱的地方；腰包（身上）带的钱；心事、想法
不届き	ふとどき	名，形動	不周到；没有礼貌、不讲理
太股	ふともも	名	大腿
太る，肥る	ふとる	自五	胖；增多
布団，蒲団	ふとん	名	蒲团、被褥、座垫的总称
鮒	ふな	名	鲫鱼
船出	ふなで	名，サ変	扬帆、（喻）初入社会
船便	ふなびん	名	海运、用船邮寄
無難	ぶなん	名，形動	平安无事；没有缺点、无可非议
不如意	ふにょい	名，形動	不如意；生活困难
赴任	ふにん	名，サ変	赴任、上任
腑抜け	ふぬけ	名，サ変	没出息、窝囊废
船，舟	ふね	名	船；槽、盆
腐敗	ふはい	名，サ変	腐烂；腐败、堕落
不備	ふび	名，形動	不周全；（书信结尾用语）书不尽言
不評	ふひょう	名	名声不好、评价低
不憫	ふびん	名，形動	可怜
部品	ぶひん	名	零件、部件
吹雪	ふぶき	名	暴风雪
不服	ふふく	名，形動	不满意、不服
部分	ぶぶん	名	部分
不平	ふへい	名，形動	不平、不满意
侮蔑	ぶべつ	名，サ変	蔑视、看不起
普遍	ふへん	名	普遍；（哲学）普通、共性
不便	ふべん	名，形動	不便、不方便
不勉強	ふべんきょう	名，形動	不用功、学习不够
父母	ふぼ	名	父母、家长
不法	ふほう	名，形動	违法、非法；不讲道理
訃報	ふほう	名	訃報
踏まえる	ふまえる	他下一	踏、踩；根据、立足于……
不満	ふまん	名，形動	不满、不满意
踏み切り	ふみきり	名	（铁道的）道口；起跳、起跳点；下决心；（相扑）脚踩出圈外
踏み切る	ふみきる	他五	起跳、起跳点；下决心；（相扑）脚踩出圈外
踏み込む	ふみこむ	自他五	陷入；深入；强行进入；踩进去
踏み台	ふみだい	名	脚登儿；垫脚石
踏み出す	ふみだす	他五	迈出；开始、着手
踏みにじる	ふみにじる	他五	践踏；伤害（名誉）
踏み外す	ふみはずす	他五	踩空；不务正业、失足
不眠	ふみん	名	不睡、睡不着
踏む	ふむ	他五	踏、踩；履行；经历过、经验过；评价、估价；押（韵）
不向き	ふむき	名，形動	不合适、不相称
不明	ふめい	名	不明、不详、不清楚；无能、见识少
不名誉	ふめいよ	名，形動	不体面
不滅	ふめつ	名，形動	不灭、不朽
不面目	ふめんぼく	名，形動	不体面、不名誉
不毛	ふもう	名，形動	不毛；没有成果
麓	ふもと	名	山麓
部門	ぶもん	名	部门
増やす，殖やす	ふやす	他五	增加
冬	ふゆ	名	冬
浮遊	ふゆう	名，サ変	浮游、飘浮
不愉快	ふゆかい	名，形動	不愉快、不痛快
不行き届き	ふゆきとどき	名，形動	不周到、疏忽、不严格
冬物	ふゆもの	名	冬装
付与，附よ	ふよ	名，サ変	授予、给予
扶養	ふよう	名，サ変	扶养
不用，不要	ふよう	名，形動	不用；没有
舞踊	ぶよう	名	舞蹈
不養生	ふようじょう	名，形動	不注意健康
不用心，無用心	ぶようじん	名，形動	不警惕、不安全
ぶよぶよ	ぶよぶよ	副，形動，サ変	柔软、虚胖
無頼	ぶらい	名，形動	无赖、恶棍；无业游民、流浪汉
部落	ぶらく	名	部落、小村庄；受到歧视的部落（略称）
ぶら下がる	ぶらさがる	自五	悬、吊垂；眼看到手；抓住
ぶら下げる	ぶらさげる	他下一	悬挂、提
不埒	ふらち	名，形動	蛮不讲理、可恶
ふらつく	ふらつく	自五	不稳、蹒跚；（心情）游移不定；溜达、闲逛
ぶらつく	ぶらつく	自五	摇晃、晃荡；信步而行、溜达
ふらふら	ふらふら	副，形動，サ変	摇晃、晃荡；糊里糊涂；犹豫不定；累得东倒西歪的样子
ぶらぶら	ぶらぶら	副，サ変	晃荡、摇晃；溜达；赋闲、闲呆着
ふらり(と)	ふらり(と)	副	突然；信步而行
振り	ふり	名，接尾	样子、打扮；假装；陌生、不速（之客）；（舞蹈的）动作、姿势；抡（棒球的球棒、高尔夫球的球拍）的动作；（接尾）把、口
不利	ふり	名，形動	不利
振り当てる	ふりあてる	他下一	分配、分派
振り替え	ふりかえ	名	调换；邮政转帐（的略称）；转帐
振り替える	ふりかえる	他下一	调换；转帐
振り返る	ふりかえる	他五	回头看、向后看；回顾
振り仮名	ふりがな	名	注在汉字旁边表示该字读法的日文假名
振り切る	ふりきる	他五	甩开、挣脱；（使劲）挥、抡；断然拒绝
振り込む	ふりこむ	他五	存款、转帐
降りしきる	ふりしきる	自五	（雨、雪）一个劲地下
振袖	ふりそで	名	（年轻姑娘的）长袖和服
振りまく	ふりまく	他五	撒、散布
振り向く	ふりむく	自五	回头看；理睬、关心
振り向ける	ふりむける	他下一	转向后边；用在……上
不慮	ふりょ	名	以外
俘虜	ふりょ	名	俘虏
不漁	ふりょう	名	捕鱼量少；收获少
不猟	ふりょう	名	捕获物少
不良	ふりょう	名	不好、坏；（品行）不良、流氓
浮力	ふりょく	名	浮力
不倫	ふりん	名，形動	男女不正当关系、乱伦
降る	ふる	自五	（雨、雪等）下、降
振る	ふる	他五	挥、摇；撒；分配、分派、附上；拒绝；甩、抛弃、不参加；放弃、丢掉；开（汇票、支票）
古い	ふるい	形	旧、老、不新鲜；陈旧、过时
篩	ふるい	名	筛子
部類	ぶるい	名	种类
振う，揮う	ふるう	自他五	挥动；发挥、显示
奮う	ふるう	自五	鼓起、振奋；积极、踊跃；兴旺、兴隆
震う	ふるう	自五	震动
篩う	ふるう	他五	筛、筛选；选拔
震える	ふるえる	自下一	震动；发抖、哆嗦、颤抖
古臭い	ふるくさい	形	陈旧、过时
古里，故郷，故里	ふるさと	名	故乡
ぶるぶる	ぶるぶる	副，サ変	哆嗦、发抖
古ぼける	ふるぼける	自下一	褪色、陈旧
古本	ふるほん	名	旧书
振る舞い	ふるまい	名	动作、举止；顷刻、设宴招待
振舞う	ふるまう	自他五	行动、动作；款待、请客
古めかしい	ふるめかしい	形	古老、陈旧
触れ合う	ふれあう	自五	互相挨着；接触
無礼	ぶれい	名，形動	失礼
触れる	ふれる	自他下一	碰、触；（耳、目）感觉到；涉及、触及；抵触、违反；通知、告知
振れる	ふれる	自下一	摇摆、颤动
風呂	ふろ	名	浴室、洗澡水；浴池、澡堂
不老	ふろう	名	不老
浮浪	ふろう	名，サ変	流浪
付録	ふろく	名	附录
風呂敷	ふろしき	名	包袱皮
不和	ふわ	名	不和、不和睦
不惑	ふわく	名	不惑之年、四十岁
ふわふわ	ふわふわ	副，サ変	暄腾腾；轻飘飘；不沉着、浮躁
付和雷同，附和雷同	ふわらいどう	名，サ変	随声附和
ふわりと	ふわりと	副	轻轻地；微微飘动、轻微摆动
文	ぶん	名	文章、句子；文
雰囲気	ふんいき	名	气氛
噴火	ふんか	名，サ変	喷火
文化	ぶんか	名	文化
文科	ぶんか	名	文科
憤慨	ふんがい	名，サ変	愤慨、气氛
分解	ぶんかい	名，サ変	（化）分解；拆卸、拆开
文学	ぶんがく	名	文艺；文艺学、文学；文史哲
分割	ぶんかつ	名，サ変	分割、分开
分岐	ぶんき	名，サ変	分叉、分歧
紛糾	ふんきゅう	名，サ変	纠纷、混乱
踏ん切り	ふんぎり	名	决断、下决心
文型	ぶんけい	名	句型
文芸	ぶんげい	名	文艺；学问和技艺
文献	ぶんけん	名	文献
文庫	ぶんこ	名	书库；藏书；丛书；（普及版的）廉价袖珍本
文語	ぶんご	名	文章用语、书面语言
粉砕	ふんさい	名，サ変	粉碎、破碎；打、粉碎
分際	ぶんざい	名	（不高的）身份、资格
分散	ぶんさん	名，サ変	分散
分子	ぶんし	名	（物）分子；（数）分子；分子、一部分人
紛失	ふんしつ	名，サ変	丢失、遗失
噴出	ふんしゅつ	名，サ変	喷出、射出
文書	ぶんしょ	名	文书、公文
文章	ぶんしょう	名	文章
文人	ぶんじん	名	文人、文士
噴水	ふんすい	名	喷水、喷水池
扮する	ふんする	サ変	装扮、假装；扮演
分析	ぶんせき	名，サ変	分析；（化学）分析
扮装	ふんそう	名，サ変	化妆、装扮、扮演
紛争	ふんそう	名，サ変	纷争、纠纷
分相応	ぶんそうおう	名，形動	合乎身份的、与身份相称的
ふんだくる	ふんだくる	他五	抢夺、硬强；（贪图暴利）敲竹杠
ふんだん	ふんだん	形動	很多
分担	ぶんたん	名，サ変	分担
文壇	ぶんだん	名	文坛
文通	ぶんつう	名，サ変	通信
憤怒	ふんど	名，サ変	愤怒
奮闘	ふんとう	名，サ変	奋战；奋斗、努力
褌	ふんどし	名	（男人的）兜裆布
糞尿	ふんにょう	名	大小便、粪尿
分配	ぶんぱい	名，サ変	分配、分给
奮発	ふんぱつ	名，サ変	发奋；（一狠心）拿出许多钱（买）
踏ん張る	ふんばる	自五	叉开双脚使劲站住；坚持、不屈服
分泌	ぶんぴつ	名，サ変	分泌
分布	ぶんぷ	名，サ変	分布
分別	ふんべつ	名，サ変	通情达理、判断（力）
分別	ふんべつ	名，サ変	分类、区分
文法	ぶんぽう	名	文法、语法
文房具	ぶんぼうぐ	名	文具
粉末	ふんまつ	名	粉末
憤懣	ふんまん	名	愤懣、气愤
文脈	ぶんみゃく	名	文章的脉络、文脉
文明	ぶんめい	名	文明
分野	ぶんや	名	领域、范围、范畴
文楽	ぶんらく	名	木偶的净琉璃戏
分離	ぶんり	名，サ変	分离
分立	ぶんりつ	名，サ変	分立
分量	ぶんりょう	名	分量、数量
分類	ぶんるい	名，サ変	分类
分裂	ぶんれつ	名，サ変	分裂、裂开
ふんわり	ふんわり	副，サ変	轻柔、轻软
塀	へい	名	围墙、墙壁
兵	へい	名	军队；军人；士兵
平安	へいあん	名，形動	平安；平安时代（794~1192）、平安朝的略语
平易	へいい	名，形動	容易、浅显
平穏	へいおん	名，形動	平稳、平静
陛下	へいか	名	陛下
閉会	へいかい	名，サ変	闭会
弊害	へいがい	名	弊病、恶劣影响
閉館	へいかん	名，サ変	闭馆
併記	へいき	名，サ変	（两种以上事项）并记、同时记
兵器	へいき	名	兵器
平気	へいき	名，形動	沉着、镇静；不在乎、无动于衷
閉業	へいぎょう	名，サ変	关店、停业
平均	へいきん	名，サ変	平均；均衡、平衡
平原	へいげん	名	平原
平行	へいこう	名，サ変	平行
平衡	へいこう	名	平衡
並行	へいこう	名，サ変	并行；同时进行
閉口	へいこう	名，サ変	受不了；为难；折服
併合	へいごう	名，サ変	合并
平行線	へいこうせん	名	平行线；（意见）对立、不一致
閉鎖	へいさ	名，サ変	封闭、关闭
平日	へいじつ	名	平常、平素；平日、星期日、节假日以外的日子
平常	へいじょう	名，副	平常
平静	へいせい	名，形動	平静、镇静
平生	へいぜい	名，副	平素、平日
併設	へいせつ	名，サ変	同时设置、附设
平然	へいぜん	形動	坦然、冷静、沉着
平素	へいそ	名，副	平素、平常
平俗	へいぞく	名，形動	平庸、一般
併存，並存	へいそん	名，サ変	并存、共存
兵隊	へいたい	名	军队、士兵
平坦	へいたん	名，形動	平坦
平淡	へいたん	名，形動	平淡
平地	へいち	名	平地
弊店	へいてん	名	（对自己商店的谦称）敝店
閉店	へいてん	名，サ変	关门、歇业
平年	へいねん	名	平年、非闰年；常年、普通年份
併発	へいはつ	名，サ変	并发（病）；同时发生
平板	へいばん	名，形動	平的板；平板、单调；（语调）没有高低起伏
平服	へいふく	名	便服
平方	へいほう	名	（数）平方（面积单位）平方
平凡	へいぼん	名，形動	平凡
閉幕	へいまく	名，サ変	闭幕；结束、告终
平民	へいみん	名	平民、老百姓
平明	へいめい	名，形動	简明
平面	へいめん	名	平面
平野	へいや	名	平原
併用	へいよう	名，サ変	并用
並立	へいりつ	名，サ変	并立、并存
並列	へいれつ	名，サ変	并列、并排；并联电路
平和	へいわ	名，形動	和睦；和平
辟易	へきえき	名，サ変	畏缩、退缩；没办法、折服
壁画	へきが	名	壁画
碧眼	へきがん	名	蓝眼珠、西洋人
僻村	へきそん	名	偏僻的村庄
僻地	へきち	名	僻壤、偏僻地方
霹靂	へきれき	名	霹雳
へこたれる	へこたれる	自下一	气馁、泄气；筋疲力尽
ぺこぺこ	ぺこぺこ	副，サ変，形動	点头哈腰、谄媚；非常饿；瘪
凹む	へこむ	自五	凹下、洼下、瘪；服输、屈服；亏空、减少
臍	へそ	名	肚脐；状似肚脐的小坑；物体中心的凸起部分
べそ	べそ	名	要哭的面孔
臍繰り	へそくり	名	私房钱
下手	へた	名，形動	拙劣、不擅长；不慎重、马虎
べた	べた	形動，名	全部；（接在动词的名词形式之前）满是、全是
下手糞	へたくそ	名，形動	拙劣（的人）
隔たり	へだたり	名	间隔、差距、不同、（关系）疏远
べたつく	べたつく	自五	发粘；（与异性）纠缠、撒娇
隔てる	へだてる	他下一	相隔；隔开、遮挡；使疏远
へたばる　	へたばる　	自五	累垮；气馁、沮丧
へたへた	へたへた	副	累得支撑不住
べたべた	べたべた	副，サ変	粘糊糊地；贴满、涂满；缠着人（撒娇）
へたり込む	へたりこむ	自五	累得一屁股坐下
べたりと	べたりと	副	粘上；（精疲力尽地）坐下
糸瓜	へちま	名	丝瓜；无用、不值一提
別	べつ	名，形動	区别；另外；各自；特别；除外、例外
別居	べっきょ	名，サ変	分开住
蔑視	べっし	名，サ変	蔑视、歧视
別条，別状	べつじょう	名	异常、毛病
別人	べつじん	名	别人、他人、另外的人
別世界	べっせかい	名	另一个世界
別荘	べっそう	名	别墅
べったり	べったり	副，サ変	粘住；纠缠、缠住；累得一屁股坐下的样子
別段	べつだん	副	特别
別途	べっと	名，副	另一种办法、其它途径；另外、另项
別に	べつに	副	特别（下接否定式）
別嬪	べっぴん	名	美人
別々	べつべつ	名，形動	各自、分别
諂う	へつらう	他五	阿谀奉承
別離	べつり	名，サ変	离别
反吐	へど	名	呕吐（物）
へなへな	へなへな	副，サ変	柔软的，易弯的；懦弱
紅	べに	名	红色颜料；口红；红色的略语
へばりつく	へばりつく	自五	依附、粘土
へばる	へばる	自五	疲惫不堪
蛇	へび	名	蛇
へべれけ	へべれけ	形動	大醉
へぼ	へぼ	名，形動	（技术）不高明；（果实）结得不好、没长好
へま	へま	名，形動	蠢笨、失败
部屋	へや	名	房间；（相扑）师傅训练徒弟的地方；宫中仕女的房间
減らす	へらす	他五	减少
減らず口	へらずぐち	名	嘴硬、强词夺理
へらへら	へらへら	副	傻笑；多嘴多舌
ぺらぺら	ぺらぺら	副，サ変	（外语）说得流利、嘴快；很薄、薄脆；连续翻纸张
箆棒	べらぼう	名，形動	混蛋；傻乎乎的、不合理的；非常
縁	へり	名	边沿；（帽）檐儿、边儿
謙る，遜る	へりくだる	自五	谦恭
屁理屈	へりくつ	名	歪理、谬论
経る	へる	自下一	时间经过；通过（场所）；经历（过程）
減る	へる	自五	减少；（后接否定）畏怯；肚子饿
ぺろり	ぺろり	副	伸舌；立刻吃光
変	へん	名，形動	（突发的）事变；（音）将半音符号；异常；形迹可疑
便	べん	名，形動	方便；大小便、特指大便
変化	へんか	名，サ変	变化；语法中词尾变化
弁解	べんかい	名，サ変	辩解
変革	へんかく	名，サ変	变革
勉学	べんがく	名，サ変	勤学
変換	へんかん	名，サ変	变换
返還	へんかん	名，サ変	归还
便宜	べんぎ	名	方便；权益（方法）
返却	へんきゃく	名，サ変	归还
偏狭	へんきょう	名，形動	狭窄
辺境	へんきょう	名	边境
勉強	べんきょう	名，サ変	学习；贱卖、便宜
返金	へんきん	名，サ変	还钱
偏屈	へんくつ	名，形動	乖僻、顽固
弁慶	べんけい	名	镰仓时期的僧侣的名字；强者
偏見	へんけん	名	偏见
弁護	べんご	名，サ変	辩护
変更	へんこう	名，サ変	变更
弁護士	べんごし	名	辩护律师
偏差	へんさ	名	偏差
返済	へんさい	名，サ変	还债、还东西
弁済	べんさい	名，サ変	偿还
編纂	へんさん	名	编纂
変死	へんし	名，サ変	横死
変事	へんじ	名	变故
返事	へんじ	名，サ変	回复、回信；答应、回答
偏執	へんしつ	名，形動	固执
変質	へんしつ	名，サ変	变质；（精神）异常
編者	へんしゃ	名	编者
変種	へんしゅ	名	变种
編集	へんしゅう	名，サ変	编辑、编纂
便所	べんじょ	名	厕所
返上	へんじょう	名，サ変	奉还、退还、放弃
弁償	べんしょう	名，サ変	赔偿
偏食	へんしょく	名，サ変	偏食
変身	へんしん	名，サ変	（形态、外形）变化、变形
返信	へんしん	名	回信
偏する	へんする	サ変	偏向、偏颇、偏激
弁ずる	べんずる	サ変	结束、办完；辨别；处理
弁ずる	べんずる	サ変	说明、申诉；辩护
編制	へんせい	名，サ変	编制
編成	へんせい	名，サ変	组织、形成
弁舌	べんぜつ	名	口才、口齿（伶俐）
変遷	へんせん	名，サ変	变迁
変装	へんそう	名，サ変	乔装、改扮
返送	へんそう	名，サ変	寄回、退回
変則	へんそく	名，サ変	不正规
変態	へんたい	名	变态；（性欲方面）变态
鞭撻	べんたつ	名，サ変	鞭策
辺地	へんち	名	偏僻地方
編著	へんちょ	名，サ変	编著
偏重	へんちょう	名，サ変	偏重
変梃	へんてこ	形動	奇特、异常
変哲	へんてつ	名，形動	出奇、奇特
返答	へんとう	名，サ変	回答
変動	へんどう	名，サ変	变动、变化
弁当	べんとう	名	盒饭
編入	へんにゅう	名，サ変	编入、插入
辺鄙	へんぴ	名，形動	偏僻、偏远
便秘	べんぴ	名	便秘
弁別	べんべつ	名，サ変	辨别
便便	べんべん	形動	（大腹）便便；虚度时光；长篇大论
弁明	べんめい	名，サ変	辩解
便覧	べんらん	名	便览、手册
便利	べんり	名，形動	方便
返礼	へんれい	名，サ変	答礼
遍歴	へんれき	名，サ変	周游；经历
弁論	べんろん	名，サ変	辩论；（法）申述、辩护
保安	ほあん	名，サ変	保安、公安
ぽい	ぽい	接尾	有点儿；容易
保育	ほいく	名，サ変	保育
哺育	ほいく	名，サ変	哺育
母音	ぼいん	名	元音
法	ほう	名	法、法律；礼节；道理
暴	ぼう	名	暴、暴力
某	ぼう	名	某
棒暗記	ぼうあんき	名，サ変	死记硬背
包囲	ほうい	名，サ変	包围
方位	ほうい	名	方位、方向
法会	ほうえ	名	经典；解说、诵读佛典；法事
放映	ほうえい	名，サ変	放映
防衛	ぼうえい	名，サ変	防卫、保卫
貿易	ぼうえき	名，サ変	贸易
望遠鏡	ぼうえんきょう	名	望远镜
鳳凰	ほうおう	名	凤凰
報恩	ほうおん	名	报恩
防音	ぼうおん	名	隔音
放課	ほうか	名	放学
放火	ほうか	名，サ変	放火、纵火
砲火	ほうか	名	炮火；交战
邦画	ほうが	名	日本画；日本电影
崩壊	ほうかい	名，サ変	崩溃
法外	ほうがい	名，形動	过分、超出限度
妨害	ぼうがい	名，サ変	妨碍
方角	ほうがく	名	方位；方向
邦楽	ほうがく	名	日本（古代）音乐
包括	ほうかつ	名，サ変	包括
砲丸	ほうがん	名	炮弹；铅球
包含	ほうがん	名，サ変	包含
放棄	ほうき	名，サ変	放弃
法規	ほうき	名	法律、法规
蜂起	ほうき	名，サ変	起义
帚	ほうき	名	扫帚
忘却	ぼうきゃく	名，サ変	忘却
防御	ぼうぎょ	名，サ変	防御
砲撃	ほうげき	名，サ変	炮击
封建	ほうけん	名	封建
方言	ほうげん	名	方言
冒険	ぼうけん	名，サ変	冒险
奉公	ほうこう	名，サ変	（为国家、社会）效劳；做雇工、佣人；当有期限的合同工；当学徒
方向	ほうこう	名	方向；方针
芳香	ほうこう	名	芳香
暴行	ぼうこう	名，サ変	暴行；强奸
報告	ほうこく	名，サ変	报告；汇报
防災	ぼうさい	名，サ変	防灾
豊作	ほうさく	名	丰收、丰年
忙殺	ぼうさつ	名，サ変	忙得不可开交
謀殺	ぼうさつ	名，サ変	谋杀
坊さん	ぼうさん	名	和尚（亲切的称呼）
奉仕	ほうし	名，サ変	（为公益事业）服务；廉价卖
放恣	ほうし	名，形動	放荡
法事	ほうじ	名	法事
帽子	ぼうし	名	帽子
防止	ぼうし	名，サ変	防止
方式	ほうしき	名	方式、手续、方法
放射	ほうしゃ	名，サ変	放射；辐射
傍若無人	ぼうじゃくぶじん	名，形動	旁若无人
報酬	ほうしゅう	名	报酬、酬金
放出	ほうしゅつ	名，サ変	喷出、放出；发放、投放；出售、处理（积压物资）；投放物资
報償	ほうしょう	名，サ変	赔偿
褒賞	ほうしょう	名	褒奖；奖品
放生	ほうじょう	名，サ変	放生
方丈	ほうじょう	名	和尚的居室；方丈、主持
豊饒	ほうじょう	名，形動	丰饶
飽食	ほうしょく	名，サ変	饱食
紡織	ぼうしょく	名	纺织
報じる	ほうじる	自他上一	报（答）；告知
奉じる	ほうじる	他上一	奉上；信奉
焙じる	ほうじる	他上一	烘、培
放心	ほうしん	名，サ変	精神恍惚；放心
方針	ほうしん	名	方针
法人	ほうじん	名	法人
邦人	ほうじん	名	（日本人自称）本国人；日本人
坊主	ぼうず	名	和尚；光头；对男孩的爱称；接在他词厚；表示亲密或讽刺
宝石	ほうせき	名	宝石
紡績	ぼうせき	名	纺纱
傍線	ぼうせん	名	（画在字旁）旁线
呆然	ぼうぜん	形動	茫然
包装	ほうそう	名，サ変	包装、收拾行李；外包装
放送	ほうそう	名，サ変	广播、播放
暴走	ぼうそう	名，サ変	狂奔；（无驾驶员的车辆）失控乱跑；冒进、鲁莽从事
法則	ほうそく	名	法规、规律
包帯	ほうたい	名	绷带
放題	ほうだい	接尾	接在词后，表示自由地、无限制地、随心所欲
膨大	ぼうだい	名，サ変	庞大
砲弾	ほうだん	名	炮弹
報知	ほうち	名，サ変	报告、报知
放置	ほうち	名，サ変	放置、置之不理
放逐	ほうちく	名，サ変	放逐、流放
包丁	ほうちょう	名	菜刀
傍聴	ぼうちょう	名，サ変	旁听
膨張	ぼうちょう	名，サ変	膨胀；增加
放っておく	ほうっておく	他五	放置、不加以处理
法廷	ほうてい	名	法庭
報道	ほうどう	名，サ変	报道
暴騰	ぼうとう	名，サ変	暴涨
冒頭	ぼうとう	名	文章等的开头；开始
放任	ほうにん	名，サ変	放任
豊年	ほうねん	名	丰年
奉納	ほうのう	名，サ変	（向神佛）奉献、献纳；祭祀神佛时举行的比赛
防波堤	ぼうはてい	名	防波堤
褒美	ほうび	名	奖品
抱負	ほうふ	名	抱负
豊富	ほうふ	名，形動	丰富
暴風	ぼうふう	名	暴风
報復	ほうふく	名，サ変	报复
彷彿	ほうふつ	名，サ変，形動	相似；浮现；模糊、隐约可见
方法	ほうほう	名	方法
方々	ほうぼう	名	各处、到处
茫茫	ぼうぼう	形動	茫茫、无边无际；草木丛生；茫然
放牧	ほうぼく	名，サ変	放牧
泡沫	ほうまつ	名	泡沫；泡影；短暂的繁荣
葬る	ほうむる	他五	埋葬；忘却、弃而不顾
亡命	ぼうめい	名，サ変	流亡、逃亡、避难
方面	ほうめん	名	方面、方向；领域
訪問	ほうもん	名，サ変	访问
坊や	ぼうや	名	男孩；未经世事的人
包容	ほうよう	名，サ変	包容、容纳
抱擁	ほうよう	名，サ変	拥抱
法要	ほうよう	名	法事
棒読み	ぼうよみ	名，サ変	照本宣科、呆板的读
暴落	ぼうらく	名，サ変	暴跌
放埓	ほうらつ	名，形動	放荡
放り出す	ほうりだす	他五	扔出；丢开、（中途）放弃；置之不管；开除
法律	ほうりつ	名	法律
暴力	ぼうりょく	名	暴力
放る，抛る	ほうる	他五	扔给；放弃
菠蔆草	ほうれんそう	名	菠菜
放浪	ほうろう	名，サ変	流浪
琺瑯	ほうろう	名	搪瓷
飽和	ほうわ	名，サ変	饱和
吠える，吼える	ほえる	自下一	（狗、野兽）吠、吼；哭喊、叫嚷
頬	ほお	名	脸颊
頬被り	ほおかぶり	名，サ変	（用毛巾）包住头和脸；假装不知
保温	ほおん	名，サ変	保温
外，他	ほか	名，助	其他地方或方位；其他人、事、物等；在……之外；只有
捕獲	ほかく	名，サ変	捕获
火影	ほかげ	名	灯光
暈す	ぼかす	他五	使颜色浓淡的界线不清；冲淡、使含糊
ぽかぽか	ぽかぽか	副，サ変	暖和的；（连续击打）噼啪
朗らか	ほがらか	形動	晴朗；舒畅、快活；（性格）开朗
保管	ほかん	名，サ変	保管
ぽかんと	ぽかんと	副，サ変	（敲打声）啪地一声；口张开貌、发呆貌
簿記	ぼき	名	（会计）记帐
補給	ほきゅう	名，サ変	补给
補強	ほきょう	名，サ変	增强
募金	ぼきん	名，サ変	募捐
僕	ぼく	代	（男子对晚辈或同辈的自称）我
牧師	ぼくし	名	牧师
北上	ほくじょう	名，サ変	北上
牧場	ぼくじょう	名	牧场
解す	ほぐす	他五	解开；消除（紧张等）
北西	ほくせい	名	西北
牧畜	ぼくちく	名	畜牧
撲滅	ぼくめつ	名，サ変	消灭
解れる	ほぐれる	自下一	解开；消除（紧张等）、（心情）舒畅
黒子	ほくろ	名	黑痣
惚け，呆け	ぼけ	名	变傻、变迟钝（的人）
補欠，補缺	ほけつ	名	补缺、候补
墓穴	ぼけつ	名	坟墓
惚ける	ぼける	自下一	脑子、反映变迟钝，糊涂
惚ける，暈ける	ぼける	自下一	模糊
保健	ほけん	名	保健
保険	ほけん	名	保险
矛	ほこ	名	矛；用矛装饰的彩车
反古，反故	ほご	名	废纸；作废
保護	ほご	名，サ変	保护
歩行	ほこう	名，サ変	步行
母校	ぼこう	名	母校
母国	ぼこく	名	祖国
矛先	ほこさき	名	矛头；（攻击的）矛头
誇らしい	ほこらしい	形	自豪的、得意的
誇り	ほこり	名	自豪、荣誉；自尊心
埃	ほこり	名	尘埃
誇る	ほこる	自五	自豪、夸耀
綻びる	ほころびる	自上一	绽线；（花蕾）绽开；（忍不住要）笑
補佐	ほさ	名，サ変	辅佐
菩薩	ぼさつ	名	菩萨
星	ほし	名	星星；斑点；星号；运势；得分；目标；嫌疑犯
保持	ほじ	名，サ変	保持
母子	ぼし	名	母子
欲しい	ほしい	形	希望得到；希望、要求
星影	ほしかげ	名	星光
ほじくる	ほじくる	他五	抠、挖；揭底、刨根问底
保釈	ほしゃく	名，サ変	保释
保守	ほしゅ	名，サ変	（机械等的）保养；保守
補修	ほしゅう	名，サ変	修补
補習	ほしゅう	名，サ変	补习
補充	ほじゅう	名，サ変	补充
募集	ぼしゅう	名，サ変	招收、招募
補助	ほじょ	名，サ変	补助
保証	ほしょう	名，サ変	保证；担保
保障	ほしょう	名，サ変	保障
補償	ほしょう	名，サ変	赔偿
干す，乾す	ほす	他五	晒、晾、烤；把（水池等的）水放掉；喝干；不给工作
補正	ほせい	名，サ変	补正、修正
保全	ほぜん	名，サ変	保全、保存
臍	ほぞ	名	肚脐
細い	ほそい	形	细、狭窄；（力量、数目等）少、微弱；饭量少；声音低而细
舗装	ほそう	名，サ変	（用柏油、混凝土）铺路
補足	ほそく	名，サ変	补充
ぼそぼそ	ぼそぼそ	副，形動，サ変	叽叽咕咕；干巴巴的
細目	ほそめ	名	眼睛眯缝着；细孔
細める	ほそめる	他下一	使细；使小
保存	ほぞん	名，サ変	保存
菩提	ぼだい	名	菩提；亡者的冥福
絆される	ほだされる	自下一	（被人情、爱情等）束缚、纠缠
牡丹餅	ぼたもち	名	（包小豆馅的）年糕团
蛍	ほたる	名	萤火虫
牡丹	ぼたん	名	牡丹
墓地	ぼち	名	坟地；公墓
歩調	ほちょう	名	步伐、步调
補聴器	ほちょうき	名	助听器
発起	ほっき	名，サ変	提出、发起；皈依
北極	ほっきょく	名	北极
没後	ぼつご	名	死后
発作	ほっさ	名	发作
没収	ぼっしゅう	名，サ変	没收
発心	ほっしん	名，サ変	信佛、出家；起念、决定
欲する	ほっする	サ変	希望；想要得到
没する	ぼっする	サ変	沉没；去世；隐没；没收
勃然	ぼつぜん	形動	勃然而起；勃然（大怒）
発足	ほっそく	名，サ変	开始活动；出发、动身
ほっそり	ほっそり	副	苗条
ほったらかす	ほったらかす	他五	弃置不顾
発端	ほったん	名	发端、起源
坊ちゃん	ぼっちゃん	名	（称他人的男孩）你儿子；少爷、娇生惯养的人
没頭	ぼっとう	名，サ変	埋头、专心致志
頬っぺた	ほっぺた	名	脸颊；非常好吃
北方	ほっぽう	名	北方
ぽつぽつ	ぽつぽつ	副，名	小窟窿；渐渐、慢慢；小点、小疙瘩
没落	ぼつらく	名，サ変	没落、衰败
ぽつり	ぽつり	副	水滴落貌；出现小洞、小点的样子；话很少的样子；孤零零
火照る	ほてる	自五	脸、身体发热
補填	ほてん	名，サ変	填补
程	ほど	名	分寸、适度；限度；身份；时间；距离；……的状况
程	ほど	助詞	……程度、左右；大致的数量；大致的场所；……越……；（后接否定表示）再也没有比……更、最
歩道	ほどう	名	人行道
解く	ほどく	他五	解开
仏	ほとけ	名	佛；仁慈的人；死者
施す	ほどこす	他五	给与；进行；加上；在众人面前显示
杜鵑，時鳥，子規，郭公，不如帰	ほととぎす	名	杜鹃、布谷、子规
程なく	ほどなく	副	不一会儿、不久
迸る	ほとばしる	自五	进出、涌出
ほとほと	ほとほと	副	实在、太
程程	ほどほど	副	适度、恰如其分
程よい	ほどよい	形	适当
辺	ほとり	名	边；特指河畔、海滨
殆ど	ほとんど	副，名	几乎；大概、大体上
穂波	ほなみ	名	麦浪
哺乳	ほにゅう	名，サ変	哺乳
骨	ほね	名，形動	骨头、骨；遗骨；骨架、支架；核心、骨干；骨气；费劲、辛苦
骨惜しみ	ほねおしみ	名，サ変	不肯吃苦、懒惰
骨折り	ほねおり	名	不辞劳苦、努力
骨組み	ほねぐみ	名	骨骼、骨架
骨身	ほねみ	名	骨肉、全身
炎	ほのお	名	火；热烈的情感
仄か	ほのか	形動	略微、隐约
ほの暗い	ほのぐらい	形	微暗
仄々	ほのぼの	副，サ変	朦胧、隐约；略感温暖
仄めかす	ほのめかす	他五	稍微透露、暗示
歩兵	ほへい	名	步兵
頬	ほほ	名	脸颊
保母	ほぼ	名	保育员
略	ほぼ	副	大致、大体
微笑ましい	ほほえましい	形	有趣的、快乐的
微笑む	ほほえむ	自五	微笑；（花）初放
誉	ほまれ	名	名誉、荣誉
褒める，誉める	ほめる	他下一	称赞
ぼやく	ぼやく	他五	嘟囔、唠叨
ぼやける	ぼやける	自下一	模糊
ほやほや	ほやほや	名，形動	热乎乎、软乎乎；不久
保有	ほゆう	名，サ変	持有
保養	ほよう	名，サ変	疗养；（饱）眼福、修养身心
ほら	ほら	感動	喂！瞧！
洞	ほら	名	洞
法螺	ほら	名	海螺；吹牛
洞穴	ほらあな	名	洞穴
堀，濠	ほり	名	护城河；沟、渠
掘り炬燵	ほりごたつ	名	（为取暖挖的）地炉
彫り物	ほりもの	名	雕刻；文身
保留	ほりゅう	名，サ変	保留
捕虜	ほりょ	名	俘虏
掘る	ほる	他五	挖、掘；挖出、发掘
彫る	ほる	他五	雕刻
惚れ込む	ほれこむ	自五	看中、迷恋
惚れ惚れ	ほれぼれ	副，サ変	迷恋、沉醉
惚れる	ほれる	自下一	迷恋、沉醉、信服；出神
幌	ほろ	名	车篷
襤褸	ぼろ	名	褴褛、破的；破绽、缺点
ほろ苦い	ほろにがい	形	味稍苦的
滅びる，亡びる	ほろびる	自上一	灭亡；灭绝
滅ぼす	ほろぼす	他五	使灭亡；使破灭
ほろほろ	ほろほろ	副	花、叶悄悄落下的样子；黯然落泪状；野鸡等的叫声
ぼろぼろ	ぼろぼろ	形動，副	破烂不堪；纷纷落下的样子；一颗颗滚下；渐渐出现；疲惫的样子
ぼろ儲け	ぼろもうけ	名，サ変	发横财
ほろ酔い	ほろよい	名	微醉
ほろり	ほろり	副	滚落状；微醉貌
本	ほん	名	书、书籍
盆	ぼん	名	盆；盂兰盆节的略语
本位	ほんい	名	本位、中心；货币本位
本意	ほんい	名	本意
本科	ほんか	名	本科
本格	ほんかく	名，形動	根本的规则、样式；正式的、真正的
本気	ほんき	名，形動	认真、正经
本業	ほんぎょう	名	正业、本职
盆暮れ	ぼんくれ	名	盂兰盆节与岁末；（盂兰盆节与岁末的）礼品
本家	ほんけ	名	本支、嫡系、始祖
盆景	ぼんけい	名	盆景
梵語	ぼんご	名	梵语
本腰	ほんごし	名	真正的干劲
盆栽	ぼんさい	名	盆栽
本質	ほんしつ	名	本质
本日	ほんじつ	名	今日
本社	ほんしゃ	名	总社；本公司；主要的神社
本性	ほんしょう	名	本性；理智、知觉
本職	ほんしょく	名	本职；专职人员
本心	ほんしん	名	知觉；本意、真心；良心
凡人	ぼんじん	名	凡人
本筋	ほんすじ	名	正道、本题
奔走	ほんそう	名，サ変	奔走、张罗
本体	ほんたい	名	原形、本来面目；主体；（哲学）本体
盆地	ぼんち	名	盆地
本当	ほんとう	名，形動	真正、真实；本来、的确、相当
本人	ほんにん	名	本人、当事人
本音	ほんね	名	原本的音色；真心话
本能	ほんのう	名	本能
煩悩	ぼんのう	名	（佛）烦恼
ほんのり	ほんのり	名	微微、稍微
本場	ほんば	名	主要产地；发祥地；交易所中上午的交易
本部	ほんぶ	名	本部
本文	ほんぶん	名	本文、正文
奔放	ほんぽう	名，形動	奔放
本末	ほんまつ	名	本末
本名	ほんみょう	名	真名
本命	ほんめい	名	赛马等的优胜候补者；最看好的人；意中人
本物	ほんもの	名	真货、真的东西
本文	ほんもん	名	正文；此文
本屋	ほんや	名	主房；书店
翻訳	ほんやく	名，サ変	（笔译的）翻译
ぼんやり	ぼんやり	副，名，サ変	隐隐约约、模糊；心不在焉、没有精神；发呆；呆子
本来	ほんらい	名，副	本来、原本；按理说
本領	ほんりょう	名	特长
翻弄	ほんろう	名，サ変	翻弄、玩弄
間	ま	名	时间；空间；房间；适时、时机；（音乐、舞曲等的）节拍间隙
真	ま	接頭，名	真正的；纯、没有杂质；（生物种类中）纯种、标准种；真实、实在
毎	まい	接頭	每
枚挙	まいきょ	名，サ変	枚举
迷子	まいご	名	走丢的孩子、迷路的孩子
舞い込む	まいこむ	自五	飞进、飘进；出乎意外的到来、进来
邁進	まいしん	名，サ変	迈进
埋葬	まいそう	名，サ変	埋葬
埋蔵	まいぞう	名，サ変	埋藏
真一文字	まいちもんじ	名	笔直、一直
毎度	まいど	名	每次；总是、屡次
埋没	まいぼつ	名，サ変	埋于；埋没
参る	まいる	自五	（谦逊语）来、去；参拜；投降、折服；变弱、累垮；迷恋
舞う	まう	自五	舞蹈；飞舞
前	まえ	名	正前方；前面；正面；面前；以前、从前；在……之前；（顺序）前面；相当于、等于
前売り	まえうり	名	预先售票
前置き	まえおき	名，サ変	前言、开场白
前金	まえきん	名	定金、预付款
前払い	まえばらい	名，サ変	预付、先付款
前触れ	まえぶれ	名	预告；先兆
前向き	まえむき	名	朝前；积极、进步
前もって	まえもって	副	事先
紛い物	まがいもの	名	赝品、伪造品
負かす	まかす	他五	打败、战胜
任せる	まかせる	他下一	委托、托付；任凭、听由
賄い	まかない	名	供给伙食（的人）
賄う	まかなう	他五	供给（伙食等）；筹措、维持、处置
摩訶不思議	まかふしぎ	名，形動	离奇
間借り	まがり	名，サ変	租用房间
罷り出る	まかりでる	自下一	（从贵人面前）退下；前去；厚着脸皮到人前去
罷り通る	まかりとおる	自五	大模大样地通过；（不好的行为）通行、通用
曲がる	まがる	自五	弯曲、倾斜；拐弯；（心眼、行为）不正
薪	まき	名	柴火
蒔絵	まきえ	名	泥金画
巻き込む	まきこむ	他五	卷入、卷进；牵连、连累
巻添え	まきぞえ	名	株连、连累
牧場	まきば	名	牧场
紛らす	まぎらす	他五	掩饰、岔开；消除
紛らわしい	まぎらわしい	形	不易分辨的、含糊的
紛れ込む	まぎれこむ	自五	混入、混进
紛れもない	まぎれもない	連語	毋庸置疑
紛れる	まぎれる	自下一	混入；（由于忙碌等）忘记、（注意力）分散
間際	まぎわ	名	正要……只时
巻く	まく	自他五	绕上，包上；围起；卷起；使打漩儿；拧、上（发条）；打卷儿
撒く	まく	他五	撒、散布；甩掉（跟踪者等）
蒔く，播く	まく	他五	播（种）
幕	まく	名	幕布；（剧）一幕；幕内级相扑力士；场合、时候
間口	まぐち	名	房屋、土地等正面的宽度；知识、活动的范围
枕	まくら	名	枕头
枕木	まくらぎ	名	枕木、垫木
枕詞	まくらことば	名	和歌中的修饰词、枕词
捲る	まくる	他五，接尾	卷起；拼命地、激烈地
鮪	まぐろ	名	金枪鱼
髷	まげ	名	发髻
負け惜しみ	まけおしみ	名	不认输、不服输
負け嫌い	まけぎらい	名，形動	不认输、不服输（的人）
負ける	まける	自他下一	输、败；屈服于、败愈；（对漆、药物等）过敏、起斑疹；让价、减价
曲げる	まげる	他下一	弯曲；歪曲；押当；放弃、改变
負けん気	まけんき	名	争强好胜的性格
孫	まご	名	孙子；隔辈、间接
真心	まごころ	名	真心、诚意
まごつく	まごつく	自五	张皇失措；徘徊
誠，真	まこと	名	真实、事实；真心、诚意；竭诚
誠に，真に	まことに	副	的确、实在
まごまご	まごまご	副，サ変	打转转、惊慌失措
まさか	まさか	名，副	万一、一旦；以备万一；决（不……）、万万（想不到……）；难以置信
正しく	まさしく	副	确实
摩擦	まさつ	名，サ変	摩擦；不和睦、闹矛盾
正に	まさに	副	的确；马上、即将
まざまざ	まざまざ	副	历历在目
増さる	まさる	自五	增加
勝る,優る	まさる	自五	优越、胜过
交ざる，混ざる，雑ざる	まざる	自五	掺杂，混杂
増し	まし	名，形動	增加、增多；胜过、强于
交える	まじえる	他下一	夹杂；交叉；交换、交
況して	まして	副	何况、况且
呪い	まじない	名	符咒、咒语
まじまじ	まじまじ	副	目不转睛地、盯着
真面目	まじめ	名，形動	认真、严肃；诚实、正派
魔術	まじゅつ	名	魔术，妖术；魔术、戏法
魔女	まじょ	名	魔术师；魔女
交じる，混じる，雑じる	まじる	自五	混、夹杂
交わる	まじわる	自五	交叉；交际
増す，益す	ます	自他五	增加、增多；加剧、更甚；增加
先ず	まず	副	最初；总之、姑且；大概
麻酔	ますい	名	麻醉
不味い	まずい	形	难吃的；笨拙；难看的、丑；不妙、不适合
貧しい	まずしい	形	贫穷；贫乏
益益	ますます	副	越发、更加
先ず先ず	まずまず	副	好歹、总算、还过得去；总之
老成る	ませる	自下一	老成、早熟
交ぜる，混ぜる	まぜる	他下一	掺入；搅拌；加入
叉	また	名	分岔处
股	また	名	胯股
又	また	副，接続	别、其他；又、也；另外；（用于疑问句）究竟、到底；并且、同时；或者
未だ	まだ	副	还、尚；另外、更加；还算；才、不过
跨る	またがる	自五	跨、骑；横跨、连续
跨ぐ	またぐ	他五	跨过、迈过
瞬く	またたく	自五	眨眼；眨眼之间；闪烁
又な	またな	接続	或是
又又	またまた	副	又、再
未だ未だ	まだまだ	副	还、仍；更
斑	まだら	名	斑点、斑驳
街，町	まち	名	城镇；街道
待ち合わせる	まちあわせる	他下一	等候会面
間近	まぢか	形動	临近、逼近
間違い	まちがい	名	错误；差错、事故
間違う	まちがう	自他五	弄错
間違える	まちがえる	他下一	弄错、搞错
街角，町角	まちかど	名	街头、拐角
待ち兼ねる	まちかねる	他下一	焦急地等待
町並	まちなみ	名	房屋的排列情况
待ち望む	まちのぞむ	他五	期盼
待ち惚け	まちぼうけ	名	白等
区区	まちまち	名，形動	各式各样、各自
真っ	まっ	接頭	真、正
松	まつ	名	松（树）；新年装饰正门的松枝；新年期间（指元旦至正月七日）；用松、竹、梅排序时的最高位
待つ	まつ	他五	等待；期待、指望
末裔	まつえい	名	后裔、子孙
真っ赤	まっか	名，形動	赤红；纯粹、完全
松飾り	まつかざり	名	新年装饰正门的松枝
末期	まっき	名	末期
真っ暗	まっくら	名，形動	漆黑；（前途等）一片黯淡
真っ黒	まっくろ	名，形動	乌黑
睫，睫毛	まつげ	名	睫毛
末期	まつご	名	临终
抹殺	まっさつ	名，サ変	抹掉、勾销；抹杀
まっしぐら	まっしぐら	副	勇往直前、猛进
真っ白	まっしろ	名，形動	雪白
真っ直ぐ	まっすぐ	名，形動	笔直；照直；正直
全く	まったく	副	完全；一点儿也（不）；实在
松茸	まつたけ	名	松蘑
真っ直中	まっただなか	名	正中间；最盛的时候
抹茶	まっちゃ	名	末茶（用于茶道）
末尾	まつび	名	末尾
末筆	まっぴつ	名	（书信结尾用语）顺致
真っ平	まっぴら	副	断然拒绝、绝对不干
末葉	まつよう	名	后裔；末叶
祭り	まつり	名	祭奠、祭祀；各种庆祝活动、节日
祭る	まつる	他五	祭祀；供奉
纏わる	まつわる　	自五	缠绕、围绕；关联
的	まと	名	靶子；目标、对象
窓	まど	名	窗户
纏う	まとう	他五	缠绕、穿上
惑う	まどう	自五	困惑
窓口	まどぐち	名	窗口；与外部联系的人、部门
纏まる	まとまる	自五	集中、归纳；统一、一致；解决、谈妥
纏める	まとめる	他下一	汇集、汇总；整理；解决、议定
正面	まとも	名，形動	正面；认真、正经
惑わす	まどわす	他五	蛊惑、扰乱；迷惑
俎板	まないた	名	俎板
眼	まなこ	名	眼珠、眼镜
眼差し	まなざし	名	眼神、视线
真夏	まなつ	名	盛夏
学ぶ	まなぶ	他五	学习（技能等）；向某人学习
愛娘	まなむすめ	名	掌上明珠
間に合う	まにあう	自五	赶上、来得及；够用、足够
免れる	まぬかれる	他下一	避免、摆脱
間抜け	まぬけ	名，形動	愚蠢、糊涂（的人）
真似	まね	名，サ変	模仿、学；（愚蠢的）举止
招く	まねく	他五	招呼；邀请；招致、引起
真似る	まねる	他下一	模仿、仿效
目の当たり	まのあたり	副	直接、亲眼
瞬き	まばたき	名，サ変	眨眼
目映い，眩い	まばゆい	形	耀眼的；（美丽得）眩目、光彩夺目；相形见拙
疎ら	まばら	形動	稀疏
麻痺	まひ	名，サ変	麻痹；失去（思考能力）、（交通）瘫痪
間引く	まびく	他五	间苗；使有间隔
眩しい	まぶしい	形	晃眼；光彩夺目
瞼	まぶた	名	眼皮
真冬	まふゆ	名	隆冬
魔法	まほう	名	魔术、妖术
幻	まぼろし	名	虚幻、幻影
まま	まま	名	原封不动、照旧；任由、随心所欲、任凭
まま親	ままおや	名	继父母、养父母
継子	ままこ	名	继子（女）；受排斥者
塗れ	まみれ	接尾	浑身
塗れる	まみれる	自下一	满身都是
豆	まめ	名	豆子；小型、微型
忠実	まめ	名，形動	勤勤恳恳、不辞辛劳；健康；认真、诚恳
肉刺	まめ	名	（手、脚）上的水泡
豆撒き	まめまき	名	撒豆；立春前夕撒豆祛邪
まめまめしい	まめまめしい	形	踏实、勤恳
魔物	まもの	名	妖魔；可怕的东西
守り，護り	まもり	名	守卫；守护神；护身符
守る，護る	まもる	他五	保卫、守备；保守、保持；遵守
麻薬	まやく	名	毒品、麻醉药
眉	まゆ	名	眉毛；眉黛
繭	まゆ	名	茧；蚕茧
眉毛	まゆげ	名	眉毛
迷う	まよう	自五	迷失（方向）；困惑；迷恋、沉迷；（佛教用语）执迷、（死者）没能成佛
魔除け	まよけ	名	辟邪、避邪物
真夜中	まよなか	名	深夜
迷わす	まよわす	他五	蛊惑、迷惑
毬，鞠	まり	名	（游戏用的）球
魔力	まりょく	名	魔力
丸	まる	名，接頭	圆；打圈儿（表示正确）；全部；整、满；全部、整个儿
丸い，円い	まるい	形	圆形的、球形的；弯曲；圆滑、圆满
丸木	まるき	名	原木
丸きり	まるきり	副	（接否定）全然、完全
丸腰	まるごし	名	徒手、没带武器
丸ごと	まるごと	副	整个儿、全部
丸出し	まるだし	名	全部露出、毫不掩饰
丸で	まるで	副	好像；（下接否定）完全、简直
丸まる	まるまる	自五	变圆
丸丸	まるまる	副	全部、完全；胖乎乎的
丸み	まるみ	名	圆形；圆满
丸める	まるめる	他下一	弄圆；剃头；拉拢
稀，希	まれ	形動	稀少
円やか	まろやか	形動	圆圆的；（味道）醇厚、（性格）沉稳
回し者	まわしもの	名	间谍
回す，廻す	まわす	他五	旋转；围绕；（依次）传递；想尽办法；转、调职
真綿	まわた	名	丝棉
回り	まわり	名，接尾	旋转；周围；巡回、巡访；蔓延、扩展；绕过、经过；圈数；（比较大小、容量的）圈
回りくどい	まわりくどい	形	拐弯抹角
回り遠い	まわりどおい	形	绕远；拐弯抹角
回り道	まわりみち	名	绕道、弯路
回る，廻る	まわる	自五	转、旋转；绕着、沿着；巡视；（依次）传递；绕弯；迂回；（在体内）发作；（动作等）灵活、灵敏；（时间）过了；周到、彻底
満	まん	名	满；（年龄）周岁
万一	まんいち	名，副	万一；倘若
満員	まんいん	名	客满、满座；挤满、载满
蔓延	まんえん	名，サ変	蔓延
漫画	まんが	名	漫画
満開	まんかい	名	盛开
満喫	まんきつ	名，サ変	饱餐、饱尝、充分领略（玩味）
万華鏡	まんげきょう	名	万花筒
満月	まんげつ	名	满月
漫才	まんざい	名	相声
満更	まんざら	副	（下接否定）不一定、并不完全
饅頭	まんじゅう	名	馒头、包子
慢性	まんせい	名	慢性；（不好状态）继续存在
満足	まんぞく	名，サ変，形動	满足、满意；圆满、完美
満点	まんてん	名	满分；最好、绝佳
真中	まんなか	名	当中
万年筆	まんねんひつ	名	自来水笔
万引き	まんびき	名，サ変	在商店等场所行窃的人
満腹	まんぷく	名，サ変	饱腹
まんまと	まんまと	副	巧妙地、漂亮地
真ん丸	まんまる	名，形動	圆溜溜
漫遊	まんゆう	名，サ変	漫游
満了	まんりょう	名，サ変	期满
実	み	名	果实；加在汤里的菜；内容
身	み	名	身体；自身；身份、处境；（动物等的）肉；地位；容器、盒体
見合い	みあい	名	相抵、相亲
見合う	みあう	自他五	对着看；均匀、相抵
見上げる	みあげる	他下一	仰望；景仰
見合わせる	みあわせる	他下一	互看；对照；暂停、推迟；取消
見入る，魅入る	みいる	自他五	凝视、看得出神；鬼怪附体
見受ける	みうける	他下一	看起来；看到
身動き	みうごき	名	动弹身体；形動
見失う	みうしなう	他五	迷失；看不见
身内	みうち	名	全身；亲戚
見栄	みえ	名	门面、外貌
見得	みえ	名	（演员）亮相
見え隠れ	みえがくれ	名，サ変	忽隐忽现
見栄っ張り	みえっぱり	名，形動	追求虚荣的人
見え見え	みえみえ	形動	显然、明显
見える	みえる	自下一	看得见；显出、显得；（敬）光临；看样子好象、似乎
見送る	みおくる	他五	送行；静观、等待下次（机会）
見落とす	みおとす	他五	忽略过去
見劣り	みおとり	名，サ変	逊色、相形见拙
見下ろす	みおろす	他五	俯瞰；轻视
未開	みかい	名	未开化；未发掘、未研究
見限る	みかぎる	他五	放弃、断念
味覚	みかく	名	味觉
磨く，研く	みがく	他五	磨光；苦练、提高（修养）
見掛け	みかけ	名	外表
見かける	みかける	他下一	见到
見方	みかた	名	看法、想法
味方	みかた	名，サ変	我方、同伙；帮着、袒护
三日月	みかづき	名	月牙；月牙形
帝	みかど	名	皇帝
身軽	みがる	名，形動	轻便（的装束）；轻松、灵活
蜜柑	みかん	名	桔子
幹	みき	名	树干；事物的主要部分
神酒，御酒	みき	名	（对酒的美称）美酒
右	みぎ	名	右；以上、前文；右倾；强的一方
見切り	みきり	名	断念、放弃
見切る	みきる	他五	看完；断念、廉价甩卖
汀	みぎわ	名	水边
見下す	みくだす	他五	看不起
見縊る	みくびる	他五	轻视
見苦しい	みぐるしい	形	难看的、丢脸的
身ぐるみ	みぐるみ	名	（身上）所有衣服
未決	みけつ	名	尚未决定；拘留（未判决）
巫女	みこ	名	女巫
神輿，御輿	みこし	名	（装有神牌位的）神较
見越す	みこす	他五	预料、预测
見事	みごと	形動	精彩、出色；彻底
見込み	みこみ	名	希望、前途
見込む	みこむ	他五	期待、信赖；缠身；估计在内、计算在内
身ごもる，妊る	みごもる	自五	怀孕
見頃	みごろ	名	正是观赏的时候
未婚	みこん	名	未婚
操	みさお	名	贞操；节操
岬	みさき	名	岬
見下げる	みさげる	他下一	蔑视
見定める	みさだめる	他下一	看准、认准
短い	みじかい	形	短；时间短暂
身支度	みじたく	名，サ変	打扮、装束
惨め	みじめ	形動	悲惨、凄惨
未熟	みじゅく	名，形動	尚未成熟；不熟练
未詳	みしょう	名	不详
身知らず	みしらず	名，形動	不自量
見知る	みしる	他五	见过、认识
微塵	みじん	名	微小、细微；碎末、切碎的东西
水	みず	名	水；洪水；（相扑）比赛暂停
水揚げ	みずあげ	名，サ変	（船）卸货；收入；让花草吸收水分
未遂	みすい	名	未遂
水入らず	みずいらず	連語	无外人
水色	みずいら	名	浅蓝色
湖	みずうみ	名	湖
見据える	みすえる	他下一	定睛而视；看准
水掻き，蹼	みずかき	名	蹼
見透かす	みすかす	他五	看透、看穿
自ら	みずから	名，副	自身；亲自
水着	みずぎ	名	游泳衣
水際	みずぎわ	名	水边；上岸前、在进入之前
水臭い	みずくさい	形	水多味不浓；见外、生分
見過ごす	みすごす	他五	视而不见；漏看、看漏
水差し	みずさし	名	水壶、水罐
水商売	みずしょうばい	名	不稳定职业，主要指酒馆、舞厅等行业
見ず知らず	みずしらず	連語	素昧平生
水溜	みずたまり	名	水洼
水っぽい	みずっぽい	形	水分多而味淡
見捨てる	みすてる	他五	抛弃、不理睬
水の泡	みずのあわ	名	水泡；（努力）白费
水辺	みずべ	名	水边
みすぼらしい	みすぼらしい	形	寒碜、简陋
水増し	みずまし	名，サ変	掺水充数；虚报
瑞々しい	みずみずしい	形	娇嫩、新鲜
水虫	みずむし	名	水中的小虫；脚气
水物	みずもの	名	饮料；变化多端、（结果）难测
魅する	みする	サ変	吸引
水割り	みずわり	名，サ変	（往酒里）兑水
店	みせ	名	店
未成年	みせいねん	名	未成年
見せ掛ける	みせかける	他下一	假装
店先	みせさき	名	店头
見せびらかす	みせびらかす	他五	炫耀、卖弄
見世物	みせもの	名	（魔术、杂耍等的）小节目；被人愚弄的对象、出洋相
見せる	みせる	他下一	出示、给看；呈现；装扮；让……看病；做给别人看（表示）决心和意志
未然	みぜん	名	未然；未然形
味噌	みそ	名	豆酱；得意之处
溝	みぞ	名	水沟；槽、纹；隔阂
未曾有	みぞう	名	空前、前所未有
晦日	みそか	名	月末
禊	みそぎ	名	在河水中洗浴净身
見損なう	みそこなう	他五	看错；错过机会
霙	みぞれ	名	雨夹雪
身丈	みたけ	名	身高；衣长
見出し	みだし	名	索引；标题
満たす	みたす	他五	填满；；满足
乱す	みだす	他五	搅乱、弄乱；扰乱
見立てる	みたてる	他下一	挑选；诊断；比作、喻为
淫ら	みだら	形動	淫乱
御手洗	みたらし	名	（神社内）洗手、漱口的地方
乱れる	みだれる	自下一	混乱；不平静、不安定
道	みち	名	道路；路程；道理；方法；领域；过程
未知	みち	名	未知
身近	みぢか	名，形動	身边；切身
見違える	みちがえる	他下一	认不出来
満ち欠け	みちかけ	名	（月的）盈亏
道草	みちくさ	名，サ変	路旁的草；途中耽搁
道筋	みちすじ	名	（通过的）道路；道理；合乎道理
満ち足りる	みちたりる	自上一	满意
道端	みちばた	名	路边
導く	みちびく	他五	领进；指导；导致；得出（结论）
未着	みちゃく	明	尚未送到
満ちる	みちる	自上一	充满；涨潮；满月；到期
蜜	みつ	名	蜂蜜；蜜糖
密	みつ	名	密集、严密；亲密；秘密
三日	みっか	名	三天、三号
見付かる	みつかる	自五	被发现；找到、看见
貢ぐ	みつぐ	他五	进贡；交钱给
見付ける	みつける	他下一	看惯；找到
三つ子	みつご	名	三胞胎；三岁小孩
密航	みっこう	名，サ変	偷渡
密告	みっこく	名，サ変	检举
密接	みっせつ	名，サ変，形動	紧挨着；密切
密着	みっちゃく	名，サ変	紧密结合
三つ	みっつ	名	三个；三岁
密度	みつど	名	密度
みっともない	みっともない	形	丑陋的、丢人的
密入国	みつにゅうこく	名，サ変	偷渡入境
密売	みつばい	名，サ変	私自贩卖、非法出售
見詰める	みつめる	他下一	注视
見積もり	みつもり	名	估计、估量
見積もる	みつもる	他五	估量；估算
密輸	みつゆ	名，サ変	（进出口的）走私
未定	みてい	名	未定
未到	みとう	名	未到达
未踏	みとう	名	足迹未到
見通し	みとおし	名	瞭望、眺望；预测、远见
見通す	みとおす	他五	看完；望得远；预测、看透
見咎める	みとがめる	他下一	查问
見所	みどころ	名	精彩场面；前途、出息
見届ける	みとどける	他下一	看到（最后）
認める	みとめる	他下一	看到；判定、认为；承认；赏识
緑	みどり	名	绿；嫩芽；乌黑发亮；绿树
嬰児	みどりご	名	婴儿
見取る	みとる	他五	看准、看清；护理病人
見惚れる	みとれる	自下一	看得入迷
皆	みな	名	各位、全体；都、全
見直す	みなおす	自他五	（景色）好转；重看；重新认识
漲る	みなぎる	自五	（水）涨满；充满、洋溢
見なす	みなす	他五	看作、认为；（姑且）当作
港	みなと	名	港口
南	みなみ	名	南
源	みなもと	名	水源；根源
見習う	みならう	他五	学习、见习
身形	みなり	名	身材；装束
見慣れる	みなれる	自下一	看惯、眼熟
醜い	みにくい	形	丑陋；（容颜）难看
見抜く	みぬく	他五	看穿、认清、识透
峰	みね	名	山顶；（刀）背；（物体的）顶部、高峰；山峦
蓑	みの	名	蓑衣
未納	みのう	名	未交
身の上	みのうえ	名	身世；命运
見逃す	みのがす	他五	饶恕、宽恕；看漏；错过
身代金	みのしろきん	名	卖身钱；赎票钱
身の程	みのほど	名	（自己的）身份、才能
実り	みのり	名	结果实；收成；成绩、成果
実る	みのる	自五	成熟；有成绩
見栄え	みばえ	名	外表美观、漂亮
見計らう	みはからえ	他五	斟酌、看着办
見放す，見離す	みはなす	他五	抛弃、放弃
見晴らす	みはらす	他五	远眺、遥望
見張る	みはる	他五	张大眼睛看；看守、监视
身振り	みぶり	名	姿态、姿势
身震い	みぶるい	名，サ変	发抖
身分	みぶん	名	处境；身份
未亡人	みぼうじん	名	寡妇
見本	みほん	名	样本；典型、例子
見舞	みまい	名	探望、慰问（品）
見舞う	みまう	他五	探望；遭受（不幸等）
見守る	みまもる	他五	注视；关怀；关注
見回す	みまわす	他五	环视
見回る	みまわる	自五	巡视
未満	みまん	名	未满
耳	みみ	名	耳朵；听力；（面包、布、纸等的）边缘
蚯蚓	みみず	名	蚯蚓
みみっちい	みみっちい	形	小气、吝啬
耳鳴り	みみなり	名	耳鸣
未明	みめい	名	凌晨、拂晓
身悶え	みもだえ	名，サ変	因痛苦而扭动身体
身持ち	みもち	名	品行；怀孕
身元，身許	みもと	名	来历、经历；身分
見物	みもの	名	值得看的东西
宮	みや	名	神社；皇宫；皇族；亲王家的称号
脈	みゃく	名	血管；脉搏；前途
脈打つ	みゃくうつ	自五	脉搏跳动；脉动
脈搏，脈拍	みゃくはく	名	脉搏
脈絡	みゃくらく	名	血管；关联、条理
土産	みやげ	名	纪念品；礼物
都	みやこ	名	首都；具有某种特点的城市
雅	みやび	名，形動	文雅、风流
雅やか	みやびやか	形動	风雅
見破る	みやぶる	他五	识破
宮参り	みやまいり	名，サ変	参拜神社；带着生后100天的孩子初次参拜出生地的守护神
見遣る	みやる	他五	远眺
妙	みょう	名，形動	巧妙；奇怪
明後日	みょうごにち	名	后天
苗字，名字	みょうじ	名	姓、姓名
明朝	みょうちょう	名	明晨
明日	みょうにち	名	明日
冥利	みょうり	名	（无意中得到的）恩惠；（外人体会不到的）幸福、最大满足
身寄り	みより	名	亲属
未来	みらい	名	（佛）来世；将来
未了	みりょう	名	未完
魅了	みりょう	名，サ変	吸引；使人入迷
魅力	みりょく	名	魅力
味醂	みりん	名	甜料酒
見る	みる	他上一	看；判断；经历；吃亏、上当；观察；照料；试试看；一见；既然；一看
診る	みる	他上一	看病
見る見る	みるみる	副	眼看着
未練	みれん	名，形動	留恋
未練がましい	みれんがましい	形	恋恋不舍的、不干脆的
見分ける	みわける	他下一	区分、识别
見渡す	みわたす	他五	远望；纵视
民営	みんえい	名	民营
民家	みんか	名	民房
民間	みんかん	名	民间；私营、私人
民芸	みんげい	名	民间工艺
民主	みんしゅ	名	民主
民衆	みんしゅう	名	民众
民宿	みんしゅく	名	投宿的农家
民族	みんぞく	名	民族
民俗	みんぞく	名	民俗
皆	みんな	名，副	各位、都
民法	みんぽう	名	民法
民謡	みんよう	名	民谣
民話	みんわ	名	民间传说
無	む	名	无、乌有；徒劳、白费
六日	むいか	名	六号；六天
無意識	むいしき	名，形動	失去知觉；无意识、不知不觉
無意味	むいみ	名，形動	无意义、无价值、没意思
無益	むえき	名，形動	无益
向かい	むかい	名	对面、对过
向かい合う	むかいあう	自五	相对、面对面
向かう	むかう	自五	面向、朝着；对、向；往、去；趋向、接近；对抗、反抗
迎える	むかえる	他下一	迎接；（时期）来临、迎来；接、邀请；迎合
昔	むかし	名	从前；（已过去的）十来年时间
昔気質	むかしかたぎ	名，形動	古板、老派、旧脑筋
昔馴染み	むかしなじみ	名	旧相识、老朋友
昔話	むかしばなし	名	传说、故事；旧话、老话
むかつく	むかつく	自五	反胃、恶心、要吐；升起、发怒
無関係	むかんけい	名，形動	无关
無関心	むかんしん	名，形動	不感兴趣、不关心
向き	むき	名	方向；核实；某一方面的人、人们
麦	むぎ	名	麦子
向き合う	むきあう	自五	相对、面对面
剥き出し	むきだし	名，形動	露出、剥开；不加掩饰、露骨
無気力	むきりょく	名，形動	没有精神
無菌	むきん	名	无菌
向く	むく	自五	向、朝；面向、适合；趋向
剥く	むく	他五	剥、削
無垢	むく	名，形動	纯洁、无污点；纯粹；（一身衣服）纯一色
報いる	むくいる	他上一	报答；报复、报仇
無口	むくち	名，形動	寡言、不爱说话
浮腫む	むくむ	自五	浮肿、虚肿
無欠	むけつ	名，形動	没有缺陷
向ける	むける	他下一	朝、向；为了；派遣、打发；挪用、拨为、用于
剥ける	むける	自下一	剥落、脱落
無限	むげん	名，形動	无限
婿	むこ	名	女婿、姑爷
惨い，酷い	むごい	形	凄惨的、悲惨的；残酷、狠毒
向こう	むこう	名	那边、前方；目的地；对面、；另一边；今后、从现在起；对方
無効	むこう	名，形動	无效、失效
向こう見ず	むこうみず	名，形動	冒失、莽撞、鲁莽
惨たらしい	むごたらしい	形	悲惨、凄惨、残酷
無言	むごん	名	无言、沉默
むさくるしい	むさくるしい	形	乱糟糟、肮脏、邋遢
貪る	むさぼる	他五	贪婪
無残	むざん	名，形動	残忍；悲惨
虫	むし	名	虫；热衷于某一事物、入迷的人；怒气、气愤、郁闷；小孩生病、发脾气闹人；对好哭、软弱、好生气的人的轻视语
無視	むし	名，サ変	无视、忽视
無地	むじ	名	没有花纹；纯一色
蒸し暑い	むしあつい	形	闷热
虫唾，虫酸	むしず	名	胃酸、酸水
狢，貉	むじな	名	獾；貂、狸；干坏事的同伙
虫歯	むしば	名	蛀牙、虫牙、臼齿
蝕む	むしばむ	他五	虫蛀、侵蚀、腐蚀
無慈悲	むじひ	名，形動	残忍、狠毒
武者	むしゃ	名	武士、战士
無邪気	むじゃき	名，形動	天真无邪；单纯
むしゃくしゃ	むしゃくしゃ	副，サ変	烦闷、乱糟糟、心烦意乱
矛盾	むじゅん	名，サ変	矛与盾；矛盾
無償	むしょう	名	无偿、免费、没有报酬
無常	むじょう	名，形動	无常、变化不定
無情	むじょう	名，形動	无情、冷酷；没有情感
無条件	むじょうけん	名	无条件
無性に	むしょうに	副	非常、特别
無職	むしょく	名	无业
無色	むしょく	名	无色；不偏不倚、中立
毟り取る	むしりとる	他五	拔掉、夺取
毟る	むしる	他五	揪、拔、撕
寧ろ	むしろ	副	宁可、莫如、与其……不如……
筵	むしろ	名	席子、草席；坐席
無心	むしん	名，形動，サ変	天真；（厚着脸皮）要钱要东西
無尽	むじん	名	无穷尽
無神経	むしんけい	名，形動	感觉迟钝、反应慢
無尽蔵	むじんぞう	名，形動	无穷无尽、取之不尽
蒸す	むす	自他五	闷热；蒸
難しい	むずかしい	形	困难、难解决；繁琐；不高兴；好挑剔的、不易相处的
むず痒い	むずがゆい	形	刺痒的
息子	むすこ	名	儿子
結	むすび	名	结合、连结；蝴蝶结；结尾、结句；饭团子
結び付く	むすびつく	自五	相结合；相互关联
結び付ける	むすびつける	他下一	拴上、系上；连接、结合
結ぶ	むすぶ	他五	系、连接、缔结；产生（结果）、凝结
むずむず	むずむず	副，サ変	发痒的样子；急不可待、跃跃欲试
娘	むすめ	名	女儿；姑娘
噎せ返る	むせかえる	自五	呛得慌；抽抽嗒嗒的哭、抽泣
無責任	むせきにん	名，形動	没有责任；不负责任
噎び泣く	むせびなく	自五	抽泣
咽ぶ，噎ぶ	むせぶ	自五	呛、噎；抽噎、抽泣
噎せる	むせる	自下一	呛、噎
無線	むせん	名	无线；无线电报、无线电话的略语
夢想	むそう	名，サ変	梦想、幻想、空想
無造作	むぞうさ	名，形動	容易、轻而易举；随便、草率、漫不经心
無駄	むだ	名，形動	徒劳、白费、无益；浪费
無断	むだん	名	擅自、自作主张
鞭	むち	名	鞭子；教鞭
無知	むち	名，形動	无知
無恥	むち	名，形動	无耻、不害羞
鞭打つ	むちうつ	自他五	鞭打；鞭策、激励
無茶	むちゃ	名，形動	蛮横、毫无道理；过分、非常
無茶苦茶	むちゃくちゃ	名，形動	毫无道理、岂有此理；乱糟糟、胡乱、粗暴；过分
夢中	むちゅう	名，形動	梦里；忘我、热衷于、着迷
睦言	むつごと	名	贴心话、枕边话
六つ	むっつ	名	六个、六岁
むっつり	むっつり	副，サ変	绷着脸、沉默寡言
睦まじい	むつまじい	形	和睦、亲密、要好
無鉄砲	むてっぽう	名，形動	鲁莽、做事冒失
無頓着	むとんじゃく	名，形動	不介意、不在乎、漫不经心
胸苦しい	むなぐるしい	形	胸口堵得慌、沉闷的
胸算用	むなざんよう	名	心中盘算
空しい，虚しい	むなしい	形	空虚的；徒然、白白地
胸	むね	名	胸、肺；心里、内心
旨	むね	名	主要、以……为宗旨、本着……精神；意思、主旨
無念	むねん	名，形動	什么也不想；懊悔、悔恨、遗憾
無能	むのう	名，形動	无能
無分別	むふんべつ	名，形動	不顾前后、轻率、莽撞
無法	むほう	名，形動	无法；粗暴、蛮横、不讲道理
謀反，謀叛	むほん	名，サ変	谋反
無味	むみ	名，形動	无味；没有趣味、乏味
無闇	むやみ	形動	胡乱、随便；过分、太
無用	むよう	名，形動	无用；无需；没事、无事；禁止
村	むら	名	村、村庄、乡村
斑	むら	名	（颜色）深浅不一、斑驳；（事物）不匀称、不齐；（性格）易变
群がる	むらがる	自五	群聚、群集
紫	むらさき	名	紫色；酱油的异称
村雨	むらさめ	名	降雨
蒸らす	むらす	他五	焖、使之蒸透
むらむら	むらむら	副，サ変	不由地，忽地
無理	むり	名，形動，サ変	不讲理、不合理；强干、硬干；不合适、有难度
無理遣り	むりやり	副	硬、强迫、强逼
無料	むりょう	名	免费、不要钱
無力	むりょく	名，形動	无力、没有能力
群れる	むれる	自下一	群聚、群集
蒸れる	むれる	自下一	蒸透、闷透、蒸熟；（热气）笼罩、闷热潮湿
無論	むろん	副	当然、不用说
目，眼	め	名，接尾	眼；视力；眼光、看法；经验；（形状、位置等）与眼相似；（网）眼、孔、格；第；相接点；（接形容词、动词后）有些、有点
芽	め	名	芽；事物的苗头
目新しい	めあたらしい	形	新颖、新奇、不常见
目当て	めあて	名	目标；企图、打算、指望
名	めい	接頭，接尾	名、有名；（表示人数）名
明	めい	名	明、明亮；眼力、见识；视力
姪	めい	名	侄女
明暗	めいあん	名	（绘画、照相）明暗、浓淡；光明与黑暗
明快	めいかい	名，形動	明快、条理清楚
明確	めいかく	名，形動	明确
銘柄	めいがら	名	商品的商标、名牌商品
明記	めいき	名，サ変	载明、写清楚
名作	めいさく	名	名作
名産	めいさん	名	有名的土特产
名刺	めいし	名	名片
名詞	めいし	名	名次
明示	めいじ	名，サ変	指示明白、明示
名所	めいしょ	名	名胜
名称	めいしょう	名	名称
命じる	めいじる	サ変	命令；任命；命名
銘じる	めいじる	サ変	铭刻于心、铭记
迷信	めいしん	名	迷信
名人	めいじん	名	名手、能手、专家；（围棋、象棋的最高等级）国手、名人
瞑想	めいそう	名，サ変	冥思、闭目沉思
命中	めいちゅう	名，サ変	命中
酩酊	めいてい	名，サ変	酩酊
冥土	めいど	名	冥府
鳴動	めいどう	名，サ変	响动、鸣动
命日	めいにち	名	忌辰
明白	めいはく	名，形動	明白、明显
冥福	めいふく	名	死后的幸福、冥福
名物	めいぶつ	名	名特产；有名、著名的事物
名簿	めいぼ	名	名册
銘銘	めいめい	名	各自
明滅	めいめつ	名，サ変	闪烁、（灯光）忽明忽灭
名目	めいもく	名	名义、名称；名目、借口
名誉	めいよ	名，形動	名誉、荣誉、光荣；名誉称号
明瞭	めいりょう	名，形動	明了、明确
滅入る	めいる	自五	沮丧、郁闷、消沉
命令	めいれい	名，サ変	命令
迷路	めいろ	名	迷途、迷路
迷惑	めいわく	名，形動，サ変	为难、打搅、麻烦
目上	めうえ	名	上司、上级、长辈
夫婦	めおと	名	夫妇
妾	めかけ	名	妾、姨太太
粧し込む	めかしこむ	自五	打扮得漂漂亮亮
目頭	めがしら	名	眼角
めかす	めかす	接尾，自五	装作……样子；打扮
目方	めかた	名	重量、分量
眼鏡	めがね	名	眼镜；眼力、判断力
女神	めがみ	名	女神
目薬	めぐすり	名	眼药；小恩、小惠、小礼物
恵まれる	めぐまれる	自下一	（蒙受）幸运、赋予、富有
芽ぐむ，萌む	めぐむ	自五	发芽
恵む	めぐむ	他五	怜悯、同情；施舍、救济
盲	めくら	名	盲人
巡らす	めぐらす	他五	转动、扭动；扭头；包围；动脑筋、筹谋
巡り合い	めぐりあい	名	意外相逢、邂逅
捲る	めくる	他五	翻开、掀开；扯下、撕
巡る	めぐる	自五	转、旋转；环绕、围绕；循环、轮回；到处走走、巡游
めげる	めげる	自下一	屈服；颓废
目先	めさき	名	眼前；目前、当前；预见
目指す	めざす	他五	瞄准；以……为目标；想得到的东西
目覚しい	めざましい	形	惊人、异常显著
目覚める	めざめる	自下一	睡醒、睁眼；觉悟、醒悟；认识到
目障り	めざわり	名，形動	碍眼、挡眼；刺眼、不顺眼
飯	めし	名	米饭；用餐，食物；生活
召し上がる	めしあがる	他五	（敬）请吃、请喝
目下	めした	名	比自己地位低、年纪轻的人
召し使う	めしつかう	他五	使唤、使用（仆人）
雌蕊	めしべ	名	雌蕊
目印	めじるし	名	记号、标记；线索
雌	めす	名	（动）雌性、母
召す	めす	他五	[呼び寄せる][招く]的敬语
珍しい	めずらしい	形	罕见；珍奇；新颖、新奇；珍贵
めそめそ	めそめそ	副，サ変	抽泣、啜泣
目立つ	めだつ	自五	显眼、显著；超群的
目玉	めだま	名	眼球；被骂
目茶	めちゃ	名，形動	不合理；过分
滅茶苦茶	めちゃくちゃ	名，形動	不合道理的、荒谬的；杂乱无章；完蛋、泡汤
鍍金	めっき	名，サ変	金属的、镀金的；虚有其表、伪装
目付き	めつき	名	目光、眼神
めっきり	めっきり	副	突然、明显、急剧
滅多	めった	形動	胡乱、鲁莽；几乎不、很少；（后接否定形式）轻易不、不常
滅亡	めつぼう	名，サ変	灭亡；衰亡
滅法	めっぽう	副，形動	非常、相当；不合情理
目出度い	めでたい	形	可喜、可贺的；头脑简单、愚蠢的；很好；幸运、顺利
愛でる	めでる	他下一	热爱；赞赏、欣赏
目処	めど	名	目标、期限；头绪
娶る	めとる	他五	娶妻
目抜き	めぬき	名	显眼
目の前	めのまえ	名	眼前、面前；不久、眼看着
芽生える	めばえる	自下一	发芽；萌生、萌芽
芽吹く	めぶく	自五	冒芽、吐芽
眩暈	めまい	名，サ変	头晕、目眩、眼花
目まぐるしい	めまぐるしい	形	瞬息万变、令人眼花缭乱的
女々しい	めめしい	形	懦弱的、女人气、不争气
目盛り	めもり	名	计算器上的刻度
目安	めやす	名	目标、基准
免疫	めんえき	名	免疫；司空见惯、习以为常
面会	めんかい	名，サ変	会见、见面、会面
免許	めんきょ	名，サ変	许可、批准；许可证、执照
面食い	めんくい	名	以貌取人、挑长相
面喰う	めんくらう	自五	惊慌失措、不知所措
面識	めんしき	名	认识、相识
免職	めんしょく	名，サ変	免职
面する	めんする	サ変	面向、面对；面临、直对
免ずる	めんずる	サ変	免除、免去；看在……的份上、看在……的情面上；解职
免税	めんぜい	名，サ変	免税
面積	めんせき	名	面积
面接	めんせつ	名，サ変	接见、会面、面试
面談	めんだん	名，サ変	面谈、面洽
面倒	めんどう	名，形動	费事、麻烦；困难、棘手；照顾、照料
面倒くさい	めんどうくさい	形	非常费事、极其麻烦
雌鳥	めんどり	名	雌鸟、母鸡
面皮	めんぴ	名	脸皮
綿棒	めんぼう	名	棉签
面貌	めんぼう	名	面貌、容貌
面目	めんぼく	名	名誉、面子；体面、面目
綿密	めんみつ	名，形動	周密、详尽、绵密
面々	めんめん	名	各自、每个人、各位
麺類	めんるい	名	面食、面类
猛威	もうい	名	来势凶猛、猛烈
儲かる	もうかる	自五	得利、赚钱；得便宜、拣便宜
設ける	もうける	他下一	预备、准备；设立、建立、制定
儲ける	もうける	他下一	得利、赚钱；生、得；占便宜、拣便宜
毛細血管	もうさい血管	名	毛细血管
申し上げる	もうしあげる	他下一	“说”的谦让语；“做”的谦让语
申し合わせる	もうしあわせる	他下一	商定、商量、协商
申し入れる	もうしいれる	他下一	表明、提出（要求等）
申し込む	もうしこむ	他五	提议、提出；预约；申请、报名
申し立てる	もうしたてる	他下一	申诉、陈诉
申し付ける	もうしつける	他下一	命令、吩咐、指示
申し出る	もうしでる	他下一	提议、建议、提出
申し分	もうしぶん	名	缺点、欠缺
亡者	もうじゃ	名	死者、幽灵、利欲熏心的人
猛獣	もうじゅう	名	猛兽
猛暑	もうしょ	名	酷暑、酷热
申し訳	もうしわけ	名	辩解、申辩；（只是形式上的）敷衍
申す	もうす	他五	（谦语）说、讲、告诉、叫做
妄想	もうそう	名，サ変	异想天开、妄想、胡思乱想
盲腸	もうちょう	名	盲肠
詣でる	もうでる	自下一	参拜
盲点	もうてん	名	盲点、盲区；漏洞
毛頭	もうとう	副	一点也、丝毫
盲導犬	もうどうけん	名	导盲犬
毛髪	もうはつ	名	毛发、头发
毛布	もうふ	名	毛毯、毯子
盲目	もうもく	名	失明、盲人；盲目
網羅	もうら	名，サ変	网罗、收集、包罗
猛烈	もうれつ	形動	猛烈、激烈
朦朧	もうろう	形動	朦胧、模糊不清
燃え上がる	もえあがる	自五	燃烧起来
燃える	もえる	自下一	燃烧、着火；火红；热情洋溢
萌える	もえる	自下一	发芽、萌芽
踠く	もがく	自五	挣扎、翻滚；焦急
模擬	もぎ	名	模拟；模仿
捥取る	もぎとる	他五	摘、扭、拧掉；夺取
目撃	もくげき	名，サ変	目击、目睹
木材	もくざい	名	木材、木料
黙殺	もくさつ	名，サ変	完全无视、置之不理
目次	もくじ	名	目次、目录
藻屑	もくず	名	海中藻类的碎屑
木製	もくせい	名	木制
目前	もくぜん	名	目前、眼前
木造	もくぞう	名	木造
目的	もくてき	名	目标、意图
黙認	もくにん	名，サ変	默认、默许
目標	もくひょう	名	目标、指挥；记号
黙々	もくもく	形動	默默地、不声不响地
潜る	もぐる	自五	潜入水中；钻进、钻入；隐藏
目録	もくろく	名	产品、目录；目次
目論見	もくろみ	名	计划、策划、企图
目論む	もくろむ	他五	企图、图谋、策划、筹划
模型	もけい	名	模型
模糊	もこ	副	模糊、不清楚
模索	もさく	名，サ変	摸索
若し	もし	副	如果、万一
文字	もじ	名	文字
若しくは	もしくは	接続	或、或者
若しも	もしも	副	假使、万一
もしもし	もしもし	感	（打招呼适用语）唉；（电话用语）喂喂
模写	もしゃ	名，サ変	摹本、临本、摹写
模造	もぞう	名，サ変	仿制、仿照
悶える	もだえる	自下一	痛苦、挣扎；苦闷、苦恼
擡げる	もたげる	他下一	拿起、举起；抬头、得势
もたもた	もたもた	副，サ変	态度不明朗、行动缓慢、慢腾腾
齎す	もたらす	他五	带来；引起
凭れる	もたれる	自下一	凭靠、倚靠；积食、不消化
餅	もち	名	年糕
持ち味	もちあじ	名	原有味道；独特风味
用いる	もちいる	他上一	使用、采用、采纳；任用、录取
糯米	もちごめ	名	糯米、江米
持ち出す	もちだす	他五	拿出来；提出、谈及；掏腰包、分担
持主	もちぬし	名	持有者、物主
喪中	もちゅう	名	服丧期
勿論	もちろん	副	理所当然
持つ	もつ	自他五	持、拿；携带；拥有；具有；怀有、抱有；承担；担负；支持、维持
目下	もっか	名，副	眼前、现在
勿体	もったい	名	装模作样、摆架子
勿体無い	もったいない	形	可惜、浪费；过分的；不胜惶恐
以て	もって	連語，接続	用、以；因为；到；因此；而且、并且
持って来い	もってこい	連語，名	恰好、最理想的、再好不过
以ての外	もってのほか	連語	意外、没想到；岂有此理
もっと	もっと	副	更、更加
最も	もっとも	副	最、顶
尤も	もっとも	形動，接続	合乎情理、正确；虽然这么说
専ら	もっぱら	副	专门、一心；独揽
縺れる	もつれる	自下一	纠结、纠缠；不灵、不听使唤
弄ぶ	もてあぞぶ	他五	摆弄；玩赏；摆布、玩弄；操纵、玩忽
持て余す	もてあます	他五	无法对付、难以处理
もてなす	もてなす	他五	应酬、接待、款待，招待
持てる	もてる	自下一	有人缘、受欢迎
元	もと	名	本源、起源；原因、起因；原来、以前；本钱、资本；成本；原料、材料
もどかしい	もどかしい	形	令人焦急、急不可待
戻す	もどす	他五	归还、退回；呕吐
基づく	もとづく	自五	基于、根据、按照；由于……而来
求む	もとむ	他五	寻找、招收
求める	もとめる	他下一	寻求、找；要求、征求；买、购买；想要、希望
元々	もともと	名，副	本来、原来；不赔不赚
元より	もとより	副	本来、当初、根本不用说、当然
戻る	もどる	自五	返回、折回；回到；退回、归还；恢复到原状态；回家
最中	もなか	名	中心、正中；最高潮处
物	もの	名	物体、物品、东西；所有物、所持物；食物；质量、材料；反之任何事物、凡事；文章
物言い	ものいい	名	措辞；异议、争论；相扑比赛中对胜负结果表示异议
物置	ものおき	名	库房
物語	ものがたり	名	谈话、讲话；故事、传说；散文体的作品、消化所、寓言等
物語る	ものがたる	他五	说话、做报告、说明；表明
物臭	ものぐさ	名，形動	做事嫌麻烦、懒惰（的人）、懒汉
物心	ものごころ	名	懂事
物腰	ものごし	名	言谈、言行；举止、态度
物事	ものごと	名	事情、事物
物差し	ものさし	名	尺子、测量器；判断的标准、尺度
物知り	ものしり	名	知识渊博、见多识广的人
物凄い	ものすごい	形	可怕、恐怖；惊人、厉害、猛烈
物種	ものだね	名	种子
物足りない	ものたりない	形	不能令人满足的、美中不足的
最早	もはや	副	（事到如今）已经
模範	もはん	名	模范、典范、榜样
喪服	もふく	名	丧服、孝衣
模倣	もほう	名，サ変	模仿、效仿
揉まれる	もまれる	自下一	互相拥挤
紅葉	もみじ	名	枫树；红叶
揉む	もむ	他五	揉、搓、捻；按摩、推拿；争辩、争论
揉め事	もめごと	名	纠纷、争执
揉める	もめる	自下一	发生争执、起纠纷
木綿	もめん	名	棉花；棉织品、面布
腿	もも	名	股、大腿
桃	もも	名	桃子、桃树
桃色	ももいろ	名	桃色、粉红色；桃色恋情
靄	もや	名	雾霭、烟雾
萌やし	もやし	名	豆芽菜
燃やす	もやす	他五	燃烧、烧；情绪高涨、燃气、激起
もやもや	もやもや	副，サ変，名	朦胧、模糊；不舒服、不舒畅；隔阂
模様	もよう	名	花样、图案；情形、样子
催す	もよおす	他五	举办、主办、举行；感觉要
最寄	もより	名	最近、附近
貰う	もらう	他五	领取、获得；收养孩子、娶媳妇；买；取得、得到、获得；被转移、被传染
洩らす	もらす	他五	露出、洒；掉落；泄密、透露；流露、发泄；遗漏；逃逸
漏らす	もらす	他五	遗漏、漏掉；泄露、走漏
森	もり	名	森林、树林
盛り上がる	もりあがる	自五	鼓起、隆起；高涨起来、热烈；涌起、冒出
盛り上げる	もりあげる	他下一	堆积、堆起；使高涨
盛り込む	もりこむ	他五	加进、添加
盛る	もる	他五	盛满、堆起；盛、装入器皿；配药
漏る	もる	自五	漏
漏れる	もれる	自下一	漏出、透出；走漏、泄露；被淘汰、被除外；流露、说出
脆い	もろい	形	脆、易坏的；脆弱；心软、易动感情的；没有耐力
諸手	もろて	名	双手
諸刃	もろは	名	双刃
文句	もんく	名	语句、表现；不满、抱怨
門限	もんげん	名	关门时间
門戸	もんこ	名	门户、门、一（个流）派
紋章	もんしょう	名	代表家族或国家的徽章
門前	もんぜん	名	门口、门前
問題	もんだい	名	问题；课题；引起争论的话题；麻烦、乱子；专题、题目
悶着	もんちゃく	名	争执、纠纷
問答	もんどう	名，サ変	回答
門番	もんばん	名	看门的人、门卫
悶々	もんもん	形動	苦闷、愁闷
八重	やえ	名	多重、多层；花瓣重叠
野営	やえい	名	野营
八百長	やおちょう	名	假比赛
八百屋	やおや	名	蔬菜店；卖菜的人
やおら	やおら	副	从容不迫地、不慌不忙
夜学	やがく	名	夜校
館	やかた	名	富人的住宅、公馆；员外、阁下
やがて	やがて	副	不久、马上；几乎、大约；结果、毕竟
喧しい	やかましい	形	吵闹、嘈杂；罗嗦，唠叨；严厉、严格；挑剔；议论纷纷
夜間	やかん	名	夜间、夜晚
焼き	やき	名	烧、烤、火候；（刀刃）淬火
山羊	やぎ	名	山羊
焼き付く	やきつく	自五	烧粘在一起；留下印象、铭刻
焼き鳥	やきとり	名	烤鸡肉串、烤鸡杂碎串
焼き払う	やきはらう	他五	烧尽、烧完、烧光
焼き物	やきもの	名	烤制食品；陶瓷器；淬火的刀剑
野球	やきゅう	名	棒球
冶金	やきん	名	冶金
夜勤	やきん	名，サ変	夜班
野禽	やきん	名	野禽
焼く	やく	他五	燃烧、焚；加热、烧红；烤制；烤；日光浴、晒黑；印相片；妒忌
約	やく	名，副	约会、大约
厄	やく	名	灾祸；厄运之年
役員	やくいん	名	负责人；领导、董事
薬害	やくがい	名	药物引起的副作用、要害
やくざ	やくざ	名	黑社会成员、流氓；赌徒；废物
役者	やくしゃ	名	演员；有才干的人、人才
役所	やくしょ	名	政府机关、官厅
躍如	やくじょ	形動	栩栩如生、逼真
役職	やくしょく	名	官职、职务；要职
躍進	やくしん	名，サ変	跃进
訳す	やくす	他五	翻译、译
薬草	やくそう	名	药用植物、药草
約束	やくそく	名，サ変	商定、约定；约会；契约；规则；宿命；指望
役立つ	やくだつ	自五	起作用、有用、有效
役立てる	やくだてる	他下一	应用、供使用
躍動	やくどう	名，サ変	跃动、跳动、（朝气）蓬勃
役人	やくにん	名	官吏、官员、公务员
薬品	やくひん	名	药品、药物
役目	やくめ	名	任务、职责、使命、作用
薬用	やくよう	名	药用
櫓	やぐら	名	箭楼、高台
役割	やくわり	名	分配任务；角色、作用
自棄	やけ	名	自暴自弃
夜景	やけい	名	夜景、夜色
焼石	やけいし	名	烧热的石头
火傷	やけど	名，サ変	烧伤、烫伤；遭殃、吃亏
焼ける	やける	自下一	燃烧、着火；烤制、烧成；晒、日光浴；变色；炽热；红霞；烧心
妬ける	やける	自下一	嫉妒、吃醋
夜行	やこう	名	夜行；夜行车
野菜	やさい	名	蔬菜、青菜
矢先	やさき	名	箭头；恰巧这时；目标、靶子
易しい	やさしい	形	容易、简单、易懂
優しい	やさしい	形	温柔、柔和；和蔼、娴淑；殷切
野師，香具師	やし	名	江湖艺人、走江湖者、摊贩
椰子	やし	名	椰子
野次馬	やじうま	名	看热闹、起哄（的人）
屋敷	やしき	名	住宅、宅第；建筑用地、地皮
養う	やしなう	他五	抚养、养育；养活、供养；饲养；收养（子女）；养成；养生、培养
矢印	やじるし	名	箭形符号
社	やしろ	名	神社、神殿、庙
野心	やしん	名	雄心、野心；祸心
安上がり	やすあがり	名，形動	省钱、俭省、廉价
安い	やすい	形	便宜、低廉、贱
易い	やすい	形，接尾	容易、简单；易……、容易……
安売り	やすうり	名，サ変	减价出售、贱卖；轻易接受、答应
安っぽい	やすっぽい	形	不值钱、便宜；庸俗、令人瞧不起、浅薄浮华
休まる	やすまる	自下一	心静、休息、安宁
休み	やすみ	名	休息；睡觉；休假；缺席、缺勤、请假；中断
休み休み	やすみやすみ	副	断断续续的、干一会儿歇一会儿
休む	やすむ	自他五	休息；睡觉；旷工、旷课、缺席、休假、请假；停歇、暂停
休める	やすめる	他下一	使身心得以放松；使……得以休息；使（农田）休耕
安物	やすもの	名	便宜货、不值钱的东西
安らか	やすらか	形動	平稳、安稳；安乐、无忧无虑
安らぐ	やすらぐ	自五	安乐、安稳、舒畅
野性	やせい	名	野性、粗野
野生	やせい	名，サ変	野生
痩せ我慢	やせがまん	名，サ変	逞能、硬撑、硬着头皮做
痩せる	やせる	自下一	消瘦；土地贫瘠
野戦	やせん	名	野战；战场、战地
屋台	やたい	名	摊床、摊位；舞台
屋台骨	やたいぼね	名	建筑物的支架；支撑物、顶梁柱
矢鱈	やたら	副，形動	任意、胡乱、过分
野鳥	やちょう	名	野鸟、山禽
家賃	やちん	名	房租
奴	やつ	名，代	（用于蔑视或亲密人之间的称呼）小子、家伙、东西；指物；他、那个家伙、那小子
八つ当たり	やつあたり	名，サ変	迁怒、乱发脾气
厄介	やっかい	名，形動	麻烦、难对付；照顾、照料、帮助
躍起	やっき	名，形動	急躁、着急；积极、热衷、拼命
矢継ぎ早	やつぎばや	名，形動	一个接一个、连续不断
薬局，薬鋪	やっきょく	名	药店、药铺；药房、取药处
奴	やっこ	名	奴仆、下人；家伙；凉拌豆腐丁
薬効	やっこう	名	药效、药力
奴豆腐	やっこ豆腐	名	凉拌豆腐丁
窶す	やつす	他五	化装、扮装
八つ	やっつ	名	八个、八岁
やっつける	やっつける	他一	干完、做完；（狠狠地）整一顿、教训、干掉；打败、击败
やって来る	やってくる	連語	“来る”的强调形
やっと	やっと	副	终于、好容易；勉强、好歹
奴ら	やつら	名	这些家伙、这些东西
窶れる	やつれる	自下一	消瘦、憔悴
宿	やど	名	家、房屋；临时住处、旅馆
雇う	やとう	他五	雇佣
野党	やとう	名	在野党
宿す	やどす	他五	怀孕；留下、留住、种下；留宿、留住
宿賃	やどちん	名	房租；旅馆费、店钱
宿屋	やどや	名	住处；旅店、旅馆、客栈
宿る	やどる	自五	居住；住宿；存在、存有；寄生；怀孕；映照、映
柳	やなぎ	名	柳、柳树
柳腰	やなぎごし	名	杨柳细腰
脂	やに	名	烟油渍；树脂；眼屎
家主	やぬし	名	一家之主、户主；房东、房主
屋根	やね	名	房顶、屋顶；盖、蓬
やばい	やばい	形	危险
矢張り	やはり	副	同样、也；依旧、依然；果然；毕竟还是、终归还是
夜半	やはん	名	半夜、夜半
野蛮	やばん	名，形動	野蛮、粗野
野卑	やひ	名，形動	粗野、下流、卑鄙
藪	やぶ	名	草丛、灌木丛；竹丛
藪医者	やぶいしゃ	名	庸医
破る	やぶる	他五	撕破、弄破；搞坏、破坏；违反；打破、突破；打败
破れる	やぶれる	自下一	破裂；破损；失败、破灭；输、被打败
敗れる	やぶれる	自下一	败北、失败
夜分	やぶん	名	夜晚、夜间
野暮	やぼ	名，形動	土气、俗气；不懂人情世故
野望	やぼう	名	野心、奢望
野暮ったい	やぼったい	形	土气、俗气
山	やま	名	山岳、小山；矿山；成堆、堆积如山；凸出的部分；成堆；最高峰、最高潮；押宝、投机
病	やまい	名	病；坏毛病
山崩れ	やまくずれ	名	山崩
山師	やまし	名	矿山工作者、找矿人；买卖山林的人；投机家；骗子
疚しい	やましい	形	内疚、愧疚
大和	やまと	名	日本的古称
山の手	やまのて	名	山的附近；（特指东京地势高的）住宅区
山登	やまのぼり	名，サ変	登山、爬山
山道	やまみち	名	山道、山路
闇	やみ	名	黑暗、黑夜；心中没数、迷惑；黑市、黑货
闇市	やみいち	名	黑市
闇相場	やみそうば	名	黑市价格
病みつく	やみつく	自五	生病；入迷、狂热
闇夜	やみよ	名	黑夜
止む	やむ	自五	停止、结束；停、罢休
病む	やむ	自他五	患病；忧虑、忧伤、烦恼
已む無く	やむなく	副	无可奈何、只好、不得不
止める	やめる	他下一	中止、取消、放弃、作罢
辞める	やめる	他下一	辞退、辞职、停（学）
寡，鰥	やもめ	名	寡妇；鳏夫
稍	やや	副	一点点、稍稍；不大工夫、一会儿；渐渐地
ややこしい	ややこしい	形	复杂、麻烦
ややもすると	ややもすると	副	动不动就、动辄
揶揄	やゆ	名，サ変	嘲弄、嘲笑、奚落、揶揄
弥生	やよい	名	旧历三月
槍	やり	名	长枪、矛；枪法；标枪
遣り方	やりかた	名	做法、手段、方法
遣り切れない	やりきれない	形	干不完、完成不了；无法忍耐、受不了
遣りっ放し	やりっぱなし	名	工作没做完就放下不管
やり手	やりて	名	干将、能手；赠送者
遣り遂げる	やりとげる	他下一	完成、做完、干到底
やり直す	やりなおす	他五	重干、重做、另做
やり場	やりば	名	送去的地方、应放的地方
遣る	やる	他五	送、派去；挪至、放在；面向；进行；给与；发生、做；举办、上演；经营、从事；喝、吃；生活；表示为别人干；给……看
やる気	やるき	名	干劲
遣る瀬無い	やるせない	形	郁郁不乐、不开心
やれやれ	やれやれ	感	（表示放心、感动得语气）哎呀；（表示失望的语气）哎呀呀
野郎	やろう	名	小子、混蛋；男人、小伙子；那家伙
柔	やわ	形動	柔软、柔弱、不结实
柔らか	やわらか	形動	柔软；温和
柔らかい	やわらかい	形	不硬的；柔软的；温和、平易的；轻松、通俗；融通的
和らげる	やわらげる	他下一	使柔和、使缓和；使文章等通俗易懂
やんちゃ	やんちゃ	名，形動	调皮、任性、淘气
やんわり	やんわり	副，サ変	温和、柔和、委婉、柔软
湯	ゆ	名	热水；澡堂、浴室；温泉
湯上り	ゆあがり	名	刚洗完澡；大浴巾；浴衣
唯一	ゆいいつ	名	唯一
遺言	ゆいごん	名，サ変	遗言、遗嘱
由緒	ゆいしょ	名	来由、来历；行为的根据；缘由、缘故
結納	ゆいのう	名	订婚礼、彩礼、聘礼、定礼
唯美	ゆいび	名	唯美
唯物	ゆいぶつ	名	唯物
有	ゆう	名	有
結う	ゆう	他五	系、结、捆扎；梳扎
友愛	ゆうあい	名	友爱
優位	ゆうい	名，形動	优势、优越地位
有意義	ゆういぎ	名，形動	有意义、有价值
誘因	ゆういん	名	诱因、原因、起因
誘引	ゆういん	名，他五	引诱、劝诱
憂鬱	ゆううつ	名，形動	忧郁、阴郁、郁闷
有益	ゆうえき	名，形動	有益、有用
優越	ゆうえつ	名，サ変	优越
遊園地	ゆうえんち	名	游乐场、娱乐场
優雅	ゆうが	名，形動	幽雅、优美
誘拐	ゆうかい	名，サ変	诱拐、拐骗
融解	ゆうかい	名，サ変	融化、融解；溶化、溶解
有害	ゆうがい	名，形動	有害、无用
遊学	ゆうがく	名，サ変	游学、留学
夕方	ゆうがた	名	傍晚
勇敢	ゆうかん	形動	勇敢
夕刊	ゆうかん	名	晚报
勇気	ゆうき	名	勇气
友誼	ゆうぎ	名	友谊、友情
遊戯	ゆうぎ	名，サ変	游戏；游戏、玩耍
悠久	ゆうきゅう	名，形動	悠久、永久
有給	ゆうきゅう	名	带工资、有薪
夕霧	ゆうぎり	名	晚雾
優遇	ゆうぐう	名，サ変	优遇、优待
夕暮れ	ゆうぐれ	名	傍晚、黄昏
遊撃	ゆうげき	名	游击；（棒球）游击手
幽玄	ゆうげん	名，形動	玄奥、奥妙、深奥、余韵
有限	ゆうげん	名，形動	有限
友好	ゆうこう	名	友好
有効	ゆうこう	名，形動	有效；起效
融合	ゆうごう	名，サ変	融合；合并；调和
融資	ゆうし	名，サ変	贷款、融资
有識	ゆうしき	名	博学多知
優秀	ゆうしゅう	名，形動	优秀
遊女	ゆうじょ	名	艺妓、歌伎；娼妓
優勝	ゆうしょう	名，サ変	优胜、冠军
友情	ゆうじょう	名	友谊
夕食	ゆうしょく	名	晚饭
友人	ゆうじん	名	朋友
有数	ゆうすう	名，形動	屈指可数、首屈一指
融通	ゆうずう	名，サ変	灵活、临机应变；通融、挪借
夕涼み	ゆうすずみ	名，サ変	傍晚纳凉
有する	ゆうする	サ変	拥有
優勢	ゆうせい	名，形動	优势
郵政	ゆうせい	名	邮政
優先	ゆうせん	名，サ変	优先
悠然	ゆうぜん	副，形動	悠然、悠闲；从容不迫
郵送	ゆうそう	名，サ変	邮寄
雄大	ゆうだい	名，形動	雄伟、宏伟、宏大
夕立	ゆうだち	名	骤雨、雷阵雨
勇断	ゆうだん	名	勇断、果断、果敢决定
優等	ゆうとう	名	优等
誘導	ゆうどう	名，サ変	诱导、引诱；诱导、感应
夕凪	ゆうなぎ	名	傍晚海上变得风平浪静
有能	ゆうのう	名，形動	有才能、能干
誘発	ゆうはつ	名，サ変	诱发、引起
夕日	ゆうひ	名	夕阳
郵便	ゆうびん	名	邮政；邮件
裕福	ゆうふく	名，形動	富裕、优裕
夕べ	ゆうべ	名	傍晚；晚会
昨夜	ゆうべ	名	昨晚
雄弁	ゆうべん	名，形動	雄辩
有望	ゆうぼう	形動	有希望、有前途
遊牧	ゆうぼく	名，サ変	游牧
有名	ゆうめい	形動	有名、著名、闻名
夕焼け	ゆうやけ	名	火烧云、晚霞
夕闇	ゆうやみ	名	薄暮、暮色、黄昏
悠々	ゆうゆう	副，形動	悠悠然；宽绰、宽裕；悠长、悠远
猶予	ゆうよ	名，サ変	犹豫；缓期、延期
悠揚	ゆうよう	形動，副	悠然、不慌张
遊覧	ゆうらん	名，サ変	游览
有利	ゆうり	形動	有利可图；有优势、有利
憂慮	ゆうりょ	名，サ変	忧虑
優良	ゆうりょう	名，形動	优良
有力	ゆうりょく	形動	有权势、有希望；有力的、站得稳脚跟的
幽霊	ゆうれい	名	幽灵、鬼魂、亡灵；有名无实
優劣	ゆうれつ	名	优劣
融和	ゆうわ	名，サ変	调和、融合；和睦、和解、妥协
誘惑	ゆうわく	名，サ変	诱惑、引诱
故	ゆえ	名	理由；来头；因……原因
所以	ゆえん	名	原因、来由、根据
床	ゆか	名	地板
愉快	ゆかい	形動	愉快、快乐
床板	ゆかいた	名	地板
浴衣	ゆかた	名	浴衣、夏天穿的和服
歪む	ゆがむ	自五	歪斜；行为不正、歪
歪める	ゆがめる	他下一	扭歪、歪曲
縁	ゆかり	名	因缘、关系
雪	ゆき	名	雪；洁白、雪白
行き当たる	ゆきあたる	自五	走到头；面对；无法进展
雪国	ゆきぐに	名	雪国、雪多的地方
行き先	ゆきさき	名	目的地；所到的地方；将来
雪だるま	ゆきだるま	名	雪人
雪解け	ゆきどけ	名	雪融、化雪；（关系）缓和、解冻
行き届く	ゆきとどく	自五	周到、周密、无微不至
行き悩む	ゆきなやむ	自五	停止、艰难前进、难以进展
行く	ゆく	自五	去、往；送到；经过、离开；上学；长大；进展；进行
逝く	ゆく	自五	死去；流失
行方	ゆくえ	名	去向、行踪；将来、前途
行く先	ゆくさき	名	目的地；将来、前途
湯気	ゆげ	名	蒸汽、热气
輸血	ゆけつ	名，サ変	输血
輸出	ゆしゅつ	名，サ変	输出、出口
柚子	ゆず	名	柚子
濯ぐ	ゆすぐ	他五	洗濯、涮
揺すぶる	ゆすぶる	他五	晃动、震撼、摇动
強請	ゆすり	名	敲诈、勒索
譲る	ゆずる	他五	转让；出让；谦让、尊让；让步；延期
輸送	ゆそう	名，サ変	输送、运输
豊か	ゆたか	形動	富裕；丰富；悠然；足够、十足
委ねる	ゆだねる	他下一	委托；奉献、献身
油断	ゆだん	名，サ変	疏忽、麻痹
癒着	ゆちゃく	名，サ変	粘连；勾结
ゆっくり	ゆっくり	副，サ変	慢慢；悠闲、充裕；迟迟；宽敞、舒服
ゆったり	ゆったり	副，サ変	宽敞、舒适；悠闲
茹でる	ゆでる	他下一	烫、煮、蒸
ゆとり	ゆとり	名	（指空间、时间、金钱、精神上的）宽裕、余裕
輸入	ゆにゅう	名，サ変	进口；引进
湯飲み	ゆのみ	名	茶碗
湯葉	ゆば	名	豆腐皮、油皮
指	ゆび	名	手指、指头
指折り	ゆびおり	名	屈指可数；掐指算来
指きり	ゆびきり	名，サ変	拉钩立誓
指先	ゆびさき	名	手指脚趾的前端、指头
指差す	ゆびさす	他五	用手指向
指輪	ゆびわ	名	戒指
弓	ゆみ	名	弓
弓矢	ゆみや	名	弓与箭；武器；武士道
夢	ゆめ	名	梦、梦想；虚幻、渺茫；希望、思想；犹豫、迷茫
夢現	ゆめうつつ	名	睡梦中、半睡半醒、似睡非睡
夢心地	ゆめごこち	名	宛如做梦、梦境、恍恍惚惚
夢にも	ゆめにも	副	做梦也没、万没……
夢幻	ゆめまぼろし	名	梦幻、虚幻、无常
夢見	ゆめみ	名	做梦、所见之梦
夢見る	ゆめみる	自他上一	做梦；梦想、幻想
由来	ゆらい	名，サ変	起源、来历；原来、本来
揺らぐ	ゆらぐ	自五	摇晃；动摇
ゆらりと	ゆらりと	副	轻轻摇晃、缓慢地
百合	ゆり	名	百合
揺り動かす	ゆりうごかす	他五	使摇晃、使动摇、摇撼、震撼
緩い	ゆるい	形	不紧、松弛；缓、不陡；不急、缓慢；不坚硬；不严厉
揺るがす	ゆるがす	他五	震动、动摇；使受惊、使不安
許す	ゆるす	他五	豁免、饶恕；允许、准许；条件允许、容许；接受；信赖、托付；放松、松弛；让、放；公认、认可；免、免除
緩む	ゆるむ	自五	松懈；减缓；坡度缓的；解冻；松懈、缓和；行情跌价
緩める	ゆるめる	他下一	放松、松懈；放慢、减慢；坡度小；缓和、放宽
緩やか	ゆるやか	形動	缓慢、平缓；慢坡、坡度小；松懈
揺れる	ゆれる	自下一	摇晃、摇动；动荡；动摇
湯沸し	ゆわかし	名	烧水壶、水壶
世	よ	名	世上、世间；人生；佛教中的过去、现在、未来三世；时势；时代
夜	よ	名	夜、晚上
夜明	よあけ	名	天亮、黎明时分
宵	よい	名	夜晚
良い	よい	名，接尾	好、优秀；美丽；恰好、适当；有益；令人满意；完成、充分；幸运；方便、没关系；关系好；希望；价格不菲；开心；用……（しよい）的形式表示简单、容易
よいしょ	よいしょ	感	用劲时发出的声音、呼嗨
酔いしれる	よいしれる	自下一	酩酊大醉；沉溺于
余韻	よいん	名	回声、反向；余韵、余味
酔う	よう	自五	喝醉；晕车或船等；陶醉、入神
用	よう	名	（要办的）事情、工作；用途、功能；上厕所
洋	よう	名	海洋；西洋的东西
容易	ようい	形動	简单、方便
用意	ようい	名，サ変	准备、预备；注意、警惕
養育	よういく	名，サ変	培养、培育
要員	よういん	名	工作人员、必要的人员
要因	よういん	名	主要原因
溶液	ようえき	名	溶液
八日	ようか	名	八天、八号
妖怪	ようかい	名	妖魔、妖怪
容喙	ようかい	名，サ変	插嘴、干预、过问
溶解，熔解	ようかい	名，サ変	融（溶）化；融（溶）解
洋菓子	ようがし	名	西点、西式糕点
羊羹	ようかん	名	羊羹
溶岩	ようがん	名	熔岩
容器	ようき	名	容器
陽気	ようき	名，形動	活泼、爽朗、快乐；气候、天气
容疑	ようぎ	名	嫌疑
要求	ようきゅう	名，サ変	要求、请求
用件	ようけん	名	要紧的事、重要之事
擁護	ようご	名，サ変	拥护、支持
用語	ようご	名	措辞、用语、术语
養護	ようご	名，サ変	培养、照顾；保健
要項	ようこう	名	要点、重点
陽光	ようこう	名	阳光、日光
ようこそ	ようこそ	感	欢迎、热烈欢迎
溶剤	ようざい	名	溶剂、溶媒
用紙	ようし	名	用纸、格式纸
要旨	ようし	名	重点、要点
養子	ようし	名	继子、养子
幼児	ようじ	名	幼儿
幼時	ようじ	名	幼时、孩提时
楊枝	ようじ	名	牙签
用事	ようじ	名	事、事情
様式	ようしき	名	文体、风格、格调；格式；作法、样式
洋室	ようしつ	名	西式房间
容赦	ようしゃ	名，サ変	宽恕、原谅；姑息、留情
要所	ようしょ	名	要冲、要地；要点
養生	ようじょう	名，サ変	养生；疗养、保养；保护、防护
洋食	ようしょく	名	西式料理、西餐
要職	ようしょく	名	要职、重要职务
養殖	ようしょく	名，サ変	养殖
要人	ようじん	名	地位重要之人、主要指政治方面的要员
用心	ようじん	名，サ変	注意、警戒、慎重、小心
様子	ようす	名	情况、情形；举止、态度；光景、征兆；缘故
要する	ようする	サ変	需要
要するに	ようするに	副	总而言之
妖精	ようせい	名	妖怪；妖怪、精灵、仙女
要請	ようせい	名，サ変	要求、愿望
陽性	ようせい	名，形動	快活、开朗；阳性反应
養成	ようせい	名，サ変	造就、培训、培养
溶接	ようせつ	名，サ変	焊接、熔接
夭折	ようせつ	名，サ変	夭折、夭亡
要素	ようそ	名	成分、要素；因素
様相	ようそう	名	样子、状态
洋装	ようそう	名	西服、西装；指书的西式装祯
様態	ようたい	名	情况、样子、状态
容体，容態	ようだい	名	病情、病状；打扮、装束
用立てる	ようだてる	他下一	用、使用；借给、垫付
幼稚	ようち	形動	年幼；幼稚
用地	ようち	名	占地、所用之地
要地	ようち	名	重地、要冲；要位
要注意	ようちゅうい	名	需要注意之事
腰痛	ようつう	名	腰痛
要点	ようてん	名	要点
用途	ようと	名	用途
容認	ようにん	名，サ変	承认、容忍
幼年	ようねん	名	幼年、幼时
曜日	ようび	名	星期
用品	ようひん	名	用具、用品
洋風	ようふう	名	西洋式
洋服	ようふく	名	西装
養分	ようぶん	名	养分
容貌	ようぼう	名	容貌、相貌
要望	ようぼう	名，サ変	迫切期望、要求、愿望
洋間	ようま	名	西式房间
羊毛	ようもう	名	羊毛
漸く	ようやく	副	总算、终于；渐渐地；好不容易、好歹
要約	ようやく	名，サ変	大意、摘要、要旨
洋々	ようよう	形動	浩渺；有前途、前途无量；汪洋
要覧	ようらん	名	概要、简章
擁立	ようりつ	名，サ変	拥立
容量	ようりょう	名	容量、容积
用量	ようりょう	名	用量、剂量
要領	ようりょう	名	要点；窍门、诀窍、方法
用例	ようれい	名	实例、例句、例子
予科	よか	名	预料
余暇	よか	名	空暇、业余时间
良かれ悪しかれ	よかれあしかれ	副	不管是好是坏、无论怎样、好歹
予感	よかん	名，サ変	预感、预兆
予期	よき	名，サ変	预期、事先所期待的
余儀ない	よぎない	形	无奈、不得已
余興	よきょう	名	余兴
預金	よきん	名，サ変	存款
欲	よく	名	欲望、贪欲
よく	よく	副	充分、完全；做得好；太好了、真好；经常；居然、难为；竟敢
翌朝	よくあさ	名	第二天早餐
抑圧	よくあつ	名，サ変	镇压、抑制、压迫、压制
抑止	よくし	名，サ変	抑制、制止
浴室	よくしつ	名	浴室
翌日	よくじつ	名	次日、第二天
抑制	よくせい	名，サ変	抑制
浴槽	よくそう	名	浴缸、浴桶
欲張る	よくばる	自五	贪得无厌、贪婪
欲望	よくぼう	名	欲望
抑揚	よくよう	名	抑扬顿挫
よくよく	よくよく	副，形動	反复地、充分地；非常、特别；万不得已
翌々	よくよく	接頭	第三
翼々	よくよく	形動	慎重、小心
余計	よけい	名，形動，副	多、更多；多余的；无用、白费；格外、越发
避ける	よける	他下一	回避、躲避；防御、挡，避
預言	よげん	名，サ変	预言、推测
横	よこ	名	横、宽；横向；旁边；横线
横顔	よこがお	名	侧面、侧脸；侧面象、侧影
横切る	よこぎる	他五	穿过、横穿
邪	よこしま	名，形動	不正经、邪恶
寄越す	よこす	他五	寄来、送过来；派人来
汚す	よごす	他五	弄脏；污染；贬低、侮辱
横好き	よこずき	名	对专业以外的事物很喜爱
横たわる	よこたわる	自五	横躺；摆着；横放、横亘
横綱	よこづな	名	相扑力士中最高等级、冠军；超群、出众
横幅	よこはば	名	宽度、宽幅
横目	よこめ	名	斜眼、斜视
横文字	よこもじ	名	横着写的文字、西洋文字
汚れ	よごれ	名	脏污、污垢；污点、不光彩的地方
汚れる	よごれる	自下一	弄脏；污染；不干净、玷污
予算	よさん	名	预算；预定经费
よし	よし	感	好了；好
由	よし	名	缘故、理由；方法、手段；内容、事由；听说
良し悪し	よしあし	名	好坏、善恶；有利有弊
よじ登る	よじのぼる	自五	攀登、攀援
誼	よしみ	名	友情、友谊；交情、因缘
予習	よしゅう	名，サ変	预习
捩る	よじる	他五	扭、弯曲
捩れる	よじれる	自下一	扭歪、拧
止す	よす	他五	停止、作罢
寄席	よせ	名	曲艺场、说书场
寄せ集め	よせあつめ	名	拼凑
寄せる	よせる	自他下一	使靠近；集中；加；赠送；接近、逼近；依靠；访问、拜访；借口、托故；寄予、寄托
予選	よせん	名，サ変	预选
余所，他所	よそ	名	别处；旁边；别人；无视、弃置不顾
装う	よそう	他五	装扮；盛水或饭等
予想	よそう	名，サ変	预计、预测；预料
装い	よそおい	名	打扮、服装；风情；装饰
装う	よそおう	他五	穿着、打扮；乔装、化妆
予測	よそく	名，サ変	预见、预测
余所見	よそみ	名，サ変	东张西望、往旁出看
余所者	よそもの	名	外来的人；局外人、圈外人
よそよそしい	よそよそしい	形	疏远、冷淡、见外
夜空	よぞら	名	夜空
与太者	よたもの	名	愚者；坏蛋、流氓
涎	よだれ	名	口水
余談	よだん	名	闲话、题外话、废话
よち	よち	名，サ変	预知
余地	よち	名	空地；余地
よちよち	よちよち	副，サ変	踉跄
四日	よっか	名	四天；四号
欲求	よっきゅう	名，サ変	强烈的希求、欲望
因って	よって	連語	因而、因此；根据；因为；利用
酔っ払う	よっぱらう	自五	喝醉酒；晕车、晕船
予定	よてい	名，サ変	预定、计划
与党	よとう	名	同党、朋友；执政党
淀む	よどむ	自五	淤塞、停滞；没有活力；不流利
夜中	よなか	名	半夜、夜半
世の中	よのなか	名	世上、社会；人生；时势、时代
余波	よは	名	余波；影响
呼ばわる	よばわる	自五	叫唤、呼唤
予備	よび	名	预备、准备
呼びかける	よびかける	他下一	打招呼、呼唤；号召、呼吁
呼び出す	よびだす	他五	叫来、唤来、传唤
呼び名	よびな	名	习惯称呼、通称
呼び戻す	よびもどす	他五	叫回来、召回；忆起
呼ぶ	よぶ	他五	呼喊；叫来；邀请；称呼、叫；引起；招致
夜更かし	よふかし	名	熬夜
夜更け	よふけ	名	也深、深夜
余分	よぶん	名，形動	多余、剩余；超额、额外
予報	よほう	名，サ変	预报
予防	よぼう	名，サ変	预防
余程	よほど	副	相当；差一点就、几乎要……
読み	よみ	名	读、念；判断
蘇る	よみがえる	自五	复苏、复活；恢复
読書き	よみかき	名，サ変	读和写
読み方	よみかた	名	读法、念法；念法；理解法
黄泉路	よみじ	名	黄泉之路、冥途
夜店	よみせ	名	夜市、夜摊
夜道	よみち	名	夜路、黑道
読み取る	よみとる	他五	读懂、领会、理解
読み物	よみもの	名	读书；读物；值得一读的文章
読む	よむ	他五	读、念、诵；阅读、理解；解毒；了解；观察、揣摩；点数；考虑棋的着数
嫁	よめ	名	儿媳妇；新娘；妻、媳妇
嫁入り	よめいり	名，サ変	出嫁
夜もすがら	よもすがら	副	通宵、整夜
四方山話	よもやまばなし	名	杂谈、闲聊、聊天
予約	よやく	名，サ変	预约；预定、预购；预约（见面、约会等）
余裕	よゆう	名	多余时间；富余时间；多余金钱；宽裕的心情；余地
寄り	より	名	聚集、集合；偏、靠
より	より	格助，副	出发点、起点；时间的起点；比较的基准；以外；更加；由于
寄り集まる	よりあつまる	自五	聚集、集合
寄り添う	よりそう	自五	贴近、挨近
拠り所	よりどころ	名	依靠、寄托；根据、依据
寄道	よりみち	名，サ変	顺路、顺道；绕道、绕远
依る，拠る，因る	よる	自五	按照；依据；缘于、因为；依靠、凭借；表示行为者
寄る	よる	自五	接近；偏向；聚集；顺路到；重叠、增多；依靠、凭借
夜	よる	名	夜间、晚上
よれよれ	よれよれ	副	皱巴巴
鎧	よろい	名	盔甲、铠甲
蹌踉ける	よろける	自下一	踉跄、东倒西歪
喜ばしい	よろこばしい	形	可喜、值得高兴、喜悦
喜び	よろこび	名	欢喜、高兴；喜事、喜庆事；道喜、贺喜
喜ぶ	よろこぶ	他五	高兴、欢喜；欣然接受
宜しい	よろしい	形	方便、适宜；好
宜しく	よろしく	副	好好地、适当地；请问好、请致意；请关照；活象
万	よろず	副	一切、万事、全部
よろめく	よろめく	自五	东倒西歪、踉跄；（俗）陷入迷魂阵
輿論	よろん	名	舆论、公论
弱い	よわい	形	软弱、虚弱；脆弱、易坏的；微弱；不擅长、经不住
弱気	よわき	名，形動	胆怯、软弱；股市低落、行情疲软
弱腰	よわごし	名	软弱、懦弱
世渡り	よわたり	名，サ変	处世、生活
弱音	よわね	名	泄气的话、不争气的话
弱み	よわみ	名	弱点、缺点
弱める	よわめる	他下一	使衰弱；使变弱；减弱、拧小
弱弱しい	よわよわしい	形	微弱、无力；虚弱、孱弱
弱る	よわる	自五	衰弱；困窘、为难、尴尬
雷雨	らいう	名	雷雨
来客	らいきゃく	名	来客
来月	らいげつ	名	下个月
礼賛	らいさん	名，サ変	颂扬、极为赞扬
来週	らいしゅう	名	下周
来世	らいせ	名	死后的世界、来世
来日	らいにち	名，サ変	来日本
来年	らいねん	名	明年、来年
来賓	らいひん	名	来宾
来訪	らいほう	名，サ変	来访
雷鳴	らいめい	名	雷鸣、雷声
裸眼	らがん	名	肉眼、裸视
楽	らく	名，形動	舒服、舒适、快乐；富裕；容易、轻松
烙印	らくいん	名	烙印
楽園	らくえん	名	乐园、天堂
落書き	らくがき	名，サ変	胡写、乱涂
落伍	らくご	名，サ変	落伍、掉队；落后
落語	らくご	名	单口相声
落差	らくさ	名	落差；差距
落札	らくさつ	名，サ変	中标、得标
落日	らくじつ	名	落日、夕阳
落成	らくせい	名，サ変	落成、竣工
落選	らくせん	名，サ変	落选、未能当选
駱駝	らくだ	名	骆驼
落第	らくだい	名，サ変	留级；不及格
落胆	らくたん	名，サ変	失望、灰心、气馁、沮丧
楽天家	らくてんか	名	乐天派、乐观主义者
落馬	らくば	名，サ変	坠马、落马
落雷	らくらい	名，サ変	落雷、霹雳
裸出	らしゅつ	名，サ変	裸露、露出
羅針盤	らしんばん	名	罗盘针、指南针
螺旋	らせん	名	螺旋状、螺旋；螺钉
裸体	らたい	名	裸体
埒	らち	名	限度、界限
拉致	らち	名，サ変	强行拉走、绑架
落下	らっか	名，サ変	坠落、下降
落下傘	らっかさん	名	降落伞
落花生	らっかせい	名	花生
楽観	らっかん	名，サ変	乐观
喇叭	らっぱ	名	喇叭、军号；吹牛、说大话
辣腕	らつわん	名	有本事、精明强干、能干
羅列	られつ	名，サ変	罗列、堆砌
欄	らん	名	专栏
乱獲	らんかく	名，サ変	滥捕、乱打
蘭学	らんがく	名	兰学、经荷兰传入日本的西洋科学
欄干	らんかん	名	栏杆、扶手
乱雑	らんざつ	名，形動	杂乱无章
乱世	らんせい	名	乱世
濫読	らんどく	名，サ変	滥读、泛读
乱暴	らんぼう	名，サ変，形動	使用暴力；粗野、粗鲁
爛漫	らんまん	形動	花开烂漫之状；天真烂漫
乱用	らんよう	名，サ変	滥用、乱用
爛々	らんらん	形動	炯炯
乱立	らんりつ	名，サ変	乱选、胡乱推荐
利益	りえき	名	赚头、利润；益处、利益
離縁	りえん	名，サ変	离婚、脱离关系
理科	りか	名	理科
理解	りかい	名，サ変	了解、理解；体谅、谅解
利害	りがい	名	利害、得失
理学	りがく	名	自然科学、理学；哲学的旧称
力作	りきさく	名	力作、精心杰作
力士	りきし	名	大力士；摔跤手、相扑家
力説	りきせつ	名，サ変	极力主张、强调
力点	りきてん	名	力点；着重点、重点
力闘	りきとう	名，サ変	竭力奋战、力战
力む	りきむ	自五	使劲、用力；虚张声势、逞强
力量	りきりょう	名	能力、本领
陸	りく	名	陆地
陸上	りくじょう	名	陆上；陆地上；田径
理屈	りくつ	名	理论、道理；（捏造的）理由、歪理
利権	りけん	名	利权、特权、专利权
俚諺	りげん	名	俚语、俗语
利己	りこ	名	自私、利己
利口	りこう	名，形動	聪明；能说会道；周到、圆满
履行	りこう	名，サ変	履行、实践
離合	りごう	名，サ変	离合
離婚	りこん	名，サ変	离婚
罹災	りさい	名，サ変	遭受灾害
離散	りさん	名，サ変	离散、逃散
利子	りし	名	利息、利钱
理事	りじ	名	理事
履修	りしゅう	名，サ変	学完、完成学业
利潤	りじゅん	名	红利、利润
栗鼠	りす	名	松鼠
利する	りする	サ変	有利、有益；利用
理性	りせい	名	理性
理想	りそう	名	理想
利息	りそく	名	利息
理智	りち	名	理智
律儀	りちぎ	名，形動	诚实、忠实、正直、耿直
離着陸	りちゃくりく	名，サ変	起飞和降落
立案	りつあん	名，サ変	筹划、设计；起草、草拟
立脚	りっきゃく	名，サ変	立足、根据
立憲	りっけん	名	立宪
立候補	りっこうほ	名，サ変	提名候选、当候选人
立秋	りっしゅう	名	立秋
立春	りっしゅん	名	立春
立証	りっしょう	名，サ変	证实、证明
立食	りっしょく	名，サ変	站着吃
立身	りっしん	名，サ変	处罚、名迹
立体	りったい	名	立体
律動	りつどう	名，サ変	节奏、节律、律动
立派	りっぱ	形動	优秀、出色；崇高、（仪表）堂堂；正派、充足；漂亮、美观；伟大、了不起
立腹	りっぷく	名，サ変	动怒、发火
立法	りっぽう	名	立法
律令	りつりょう	名	法规、法律
利点	りてん	名	长处、优点
離乳	りにゅう	名，サ変	断奶
利尿	りにょう	名	利尿
離任	りにん	名，サ変	离职、离任
理念	りねん	名	观念、根本想法、最高境界
理髪	りはつ	名，サ変	理发
離反	りはん	名，サ変	反叛、叛离
罹病	りびょう	名，サ変	患病、得病
理不尽	りふじん	名，形動	无理、不讲道理
離別	りべつ	名，サ変	别离；离婚
裏面	りめん	名	里面、背面；内幕
略	りゃく	名	省略；大致上
略語	りゃくご	名	略与、略写
略字	りゃくじ	名	简化字
略す	りゃくす	他五	省略、缩减
理由	りゆう	名	根据、理由
留意	りゅうい	名，サ変	留心
流域	りゅういき	名	流域
硫化	りゅうか	名，サ変	硫化
留学	りゅうがく	名，サ変	留学
流感	りゅうかん	名	流行性感冒、流感
隆起	りゅうき	名，サ変	隆起、凸起
流儀	りゅうぎ	名	作法、作风；流派
竜宮	りゅうぐう	名	龙宫
流血	りゅうけつ	名	流血
流言	りゅうげん	名	流言、谣言、传言
流行	りゅうこう	名，サ変	流行、时尚、时髦；疾病流行
硫酸	りゅうさん	名	硫酸
粒子	りゅうし	名	粒子、微粒、颗粒
流失	りゅうしつ	名，サ変	流失、冲走
流出	りゅうしゅつ	名，サ変	流出；外流
流星	りゅうせい	名	流行
隆盛	りゅうせい	名，形動	隆盛、兴盛
留置	りゅうち	名，サ変	拘留、拘押
流暢	りゅうちょう	名，形動	水流顺畅；流利、流畅
流通	りゅうつう	名，サ変	换气、循环；通用、流通
流動	りゅうどう	名，サ変	流动
流入	りゅうにゅう	名，サ変	流进
留任	りゅうにん	名，サ変	留任、留职
留年	りゅうねん	名，サ変	留级
流派	りゅうは	名	流派
流氷	りゅうひょう	名	流冰、浮冰
流量	りゅうりょう	名	流量
寮	りょう	名	宿舍
両	りょう	名	两、双
良	りょう	名	良好、优良
利用	りよう	名，サ変	利用
両足	りょうあし	名	两脚
領域	りょういき	名	领域；范围
凌駕	りょうが	名，サ変	凌驾、超过
了解	りょうかい	名，サ変	理解；承诺、应允
諒解	りょうかい	名，サ変	谅解、懂得、理解
領海	りょうかい	名	领海
両替	りょうがえ	名，サ変	兑调、兑换
両側	りょうがわ	名	两侧
猟奇	りょうき	名	猎奇、好奇
両極	りょうきょく	名	南极、北极；阴极、阳极
料金	りょうきん	名	费用、手续费
領空	りょうくう	名	领空
了見	りょうけん	名，サ変	思想、意向、心胸；判断、决定
良好	りょうこう	名，形動	良好
良妻	りょうさい	名	贤妻
漁師	りょうし	名	渔夫
領事	りょうじ	名	领事
良識	りょうしき	名	理智、明智
良質	りょうしつ	名，形動	优质、上等
領主	りょうしゅ	名	领主、元首
領収	りょうしゅう	名，サ変	接受
了承	りょうしょう	名，サ変	了解、承认、同意
陵辱，凌辱	りょうじょく	名，サ変	凌辱、欺负；强奸
両親	りょうしん	名	双亲
良心	りょうしん	名	良心
両性	りょうせい	名	（男女、雌雄）两性；阴性和阳性
両棲	りょうせい	名	两栖
両端	りょうたん	名	两端；首尾
領地	りょうち	名	领地
両手	りょうて	名	左右手
料亭	りょうてい	名	日本是高级饭店
領土	りょうど	名	领土
両方	りょうほう	名	两边、两侧；双方
両面	りょうめん	名	双面、两面；两个方面
良薬	りょうやく	名	良药
療養	りょうよう	名，サ変	疗养
繚乱	りょうらん	副	缭乱
料理	りょうり	名，サ変	菜肴；处理
両立	りょうりつ	名，サ変	两立、并立
旅客	りょかく	名	旅行者
旅館	りょかん	名	旅馆
緑樹	りょくじゅ	名	绿树
緑色	りょくしょく	名	绿色
緑地	りょくち	名	绿地
緑茶	りょくちゃ	名	绿茶
旅券	りょけん	名	护照
旅行	りょこう	名，サ変	旅行者
旅愁	りょしゅう	名	旅愁
旅情	りょじょう	名	旅情、旅愁
旅費	りょひ	名	旅费
離陸	りりく	名，サ変	离陆、起飞
凛々しい	りりしい	形	威风凛凛、英勇、勇敢
履歴	りれき	名	履历、来历
履歴書	りれきしょ	名	履历书
理論	りろん	名	理论
隣家	りんか	名	邻居
臨海	りんかい	名	沿海
臨界	りんかい	名	临界
輪郭	りんかく	名	大概
臨機応変	りんきおうへん	名，形動	随机应变
林業	りんぎょう	名	林业
林檎	りんご	名	苹果
隣国	りんこく	名	邻国、邻邦
臨時	りんじ	名	临时；暂时
隣室	りんしつ	名	隔壁房间
臨終	りんじゅう	名	临终
臨床	りんしょう	名	临床
隣人	りんじん	名	邻居
臨席	りんせき	名，サ変	列席、出席、光临
隣接	りんせつ	名，サ変	临接
輪タク	りんタク	名	拖斗三轮车
輪廻	りんね	名，サ変	轮回
倫理	りんり	名	伦理、道德
林立	りんりつ	名，サ変	林立
凛冽	りんれつ	形動	凛冽
類	るい	名	种类；类型；分类
累加	るいか	名，サ変	累加、累积
類義語	るいぎご	名	近义词
累計	るいけい	名，サ変	累计
類型	るいけい	名	类型；概念化、公式化
類似	るいじ	名，サ変	类似
類推	るいすい	名，サ変	类比、类推
累積	るいせき	名，サ変	累积
類別	るいべつ	名，サ変	分类
累々	るいるい	形動	累累、层叠交织
類例	るいれい	名	相似的例子
流罪	るざい	名	发配、流放
留守	るす	名，サ変	不在家；疏忽、忽略
留守番	るすばん	名	看家、看门
流説	るせつ	名	流言；传说
坩堝	るつぼ	名	坩埚；狂热、欢腾；混杂
流転	るてん	名，サ変	轮回、变迁
流布	るふ	名，サ変	散步、传播流传
瑠璃	るり	名	蓝宝石；琉璃、玻璃
流浪	るろう	名，サ変	流浪、漂泊、流荡、流落
礼	れい	名	礼仪；致礼；感谢；谢礼；返礼
例	れい	名	前例、先例；常例、惯例；与往常一样；例子、事例；知彼此知道的人或事
霊	れい	名	灵魂、精神；魂灵；万物的精气神灵
零	れい	名	零
冷夏	れいか	名	凉夏
零下	れいか	名	零下
例会	れいかい	名	例会
例解	れいかい	名，サ変	举例说明
例外	れいがい	名	例外
冷害	れいがい	名	冻灾、冻害
礼儀	れいぎ	名	礼仪
冷却	れいきゃく	名，サ変	冷却；冷静
礼金	れいきん	名	礼金、酬金
冷遇	れいぐう	名，サ変	冷遇
冷血	れいけつ	名	体温低；无情
冷酷	れいこく	名，形動	冷酷、无情
霊魂	れいこん	名	灵魂
零細	れいさい	名，形動	零碎、零星、少量
礼式	れいしき	名	规矩、礼仪、礼法
冷笑	れいしょう	名，サ変	冷笑
令嬢	れいじょう	名	令嫒、令千金
冷水	れいすい	名	冷水
冷静	れいせい	名，形動	冷静、沉着
礼節	れいせつ	名	礼貌、礼节
冷戦	れいせん	名	冷战
冷然	れいぜん	形動	冰冷；冷淡
礼装	れいそう	名	礼服
冷蔵	れいぞう	名，サ変	冷藏
令息	れいそく	名	令郎、令嗣、公子、您儿子
隷属	れいぞく	名，サ変	隶属
冷淡	れいたん	名，形動	冷淡；不关心
零点	れいてん	名	零分；冰点
零度	れいど	名	零度
冷凍	れいとう	名，サ変	冷冻
例年	れいねん	名	往年；每年
冷罵	れいば	名，サ変	嘲弄、冷嘲、讥骂、谩骂
礼服	れいふく	名	礼服
例文	れいぶん	名	例文
礼砲	れいほう	名	礼炮
礼法	れいほう	名	礼仪、礼节、礼法
冷房	れいぼう	名，サ変	冷气设bei
怜悧	れいり	名，形動	伶俐、聪明
歴史	れきし	名	历史；史学
轢死	れきし	名，サ変	轧死、碾死
歴然	れきぜん	形動	明确、明显、确凿、昭然若揭
歴代	れきだい	名	历代、历届
歴任	れきにん	名，サ変	历任
列	れつ	名	列、队列、队；行列
れっきとした	れっきとした	連体	高贵、像样的、了不起的；确凿、明显
列挙	れっきょ	名，サ変	列举、枚举
列車	れっしゃ	名	列车
列する	れっする	サ変	出席；列入、加入
劣勢	れっせい	名，形動	劣势
列席	れっせき	名，サ変	出席、列席
列島	れっとう	名	列岛、群岛
劣等	れっとう	名	劣等
恋愛	れんあい	名，サ変	恋爱
廉価	れんか	名	价格便宜
恋歌	れんか	名	恋歌、情歌
煉瓦	れんが	名	砖
連歌	れんが	名	连歌
連休	れんきゅう	名	连休
蓮華	れんげ	名	莲花、荷花；紫云英；调羹、小磁勺
連携	れんけい	名，サ変	联合、合作
廉潔	れんけつ	名，形動	清廉、廉洁
連結	れんけつ	名，サ変	联结、连接
連合	れんごう	名，サ変	结合、联合
蓮根	れんこん	名	藕
連鎖	れんさ	名，サ変	连锁、锁链
連座	れんざ	名，サ変	同坐一席；牵连、连坐、株连
連載	れんさい	名，サ変	连载、连续刊载
連日	れんじつ	名	连接几日、连日
練習	れんしゅう	名，サ変	练习
連勝	れんしょう	名，サ変	连胜
連想	れんそう	名，サ変	联想
連続	れんぞく	名，サ変	连续
連帯	れんたい	名，サ変	联合、合作
連中	れんちゅう	名	伙伴、一群人
連動	れんどう	名，サ変	连锁、传动、联动
連覇	れんぱ	名，サ変	连胜、连续取得冠军
連発	れんぱつ	名，サ変	接连发射；接连发生
憐憫	れんびん	名	怜悯、同情、怜惜
恋慕	れんぼ	名，サ変	爱慕、恋慕
連邦	れんぽう	名	联邦
連名	れんめい	名	联名
連盟	れんめい	名	同盟、联合会
連綿	れんめん	形動	连续不断、连绵
連絡	れんらく	名，サ変	联络；接连；通知、告诉
連立	れんりつ	名，サ変	联合
老	ろう	名，接尾	老；年老的
漏洩	ろうえい	名，サ変	漏了、漏出、外漏；泄露
廊下	ろうか	名	走廊、廊子
労	ろう	名	辛劳、劳苦；功劳
労苦	ろうく	名	辛苦、劳苦
老後	ろうご	名	老后、晚年
牢獄	ろうごく	名	牢狱、监狱
労作	ろうさく	名，サ変	劳动；力作
老弱	ろうじゃく	名，形動	老幼；年老体弱
陋習	ろうしゅう	名	陋习
漏出	ろうしゅつ	名，サ変	漏出
朗誦	ろうしょう	名，サ変	朗诵、朗读
老人	ろうじん	名	老人
労する	ろうする	サ変	劳苦、劳作；劳累
弄する	ろうする	サ変	嘲弄；玩弄、卖弄
老成	ろうせい	名，サ変	圆滑、老练；老成
狼藉	ろうぜき	名	杂乱；无理、粗鲁
漏電	ろうでん	名，サ変	漏电
労働	ろうどう	名，サ変	劳动
労働者	ろうどうしゃ	名	劳动者、工人
朗読	ろうどく	名，サ変	朗读、朗诵
老若	ろうにゃく	名	老少
浪人	ろうにん	名	失去主人的流浪武士；失业者、考不上大学、找不到工作的毕业生
老年	ろうねん	名	老年
狼狽	ろうばい	名，サ変	狼狈、惊慌失措
蝋梅	ろうばい	名	腊梅
浪費	ろうひ	名，サ変	浪费
朗報	ろうほう	名	喜报、喜讯
浪漫	ろうまん	名	浪漫、罗曼
牢屋	ろうや	名	牢狱、监狱
労力	ろうりょく	名	劳动力、人手；费神、费力
朗々	ろうろう	副	朗朗、嘹亮、响亮、清彻
濾過	ろか	名，サ変	过滤
録音	ろくおん	名，サ変	录音
録画	ろくが	名，サ変	录像
六月	ろくがつ	名	六月份
碌な	ろくな	連体	令人满意的、好的
碌に	ろくに	副	（下接否定）满意、充分、很好
露見	ろけん	名，サ変	败露、暴露
露骨	ろこつ	名，形動	露骨、直率；卑猥、毫不掩饰
濾紙	ろし	名	过滤纸
路地	ろじ	名	小巷、胡同
露出	ろしゅつ	名，サ変	露出、外露；曝光
路線	ろせん	名	路线；（方针）路线
露台	ろだい	名	阳台、晒台
肋骨	ろっこつ	名	肋骨
露天	ろてん	名	露天
露店	ろてん	名	街头店、摊位、摊贩
路頭	ろとう	名	路旁、路边、街头
驢馬	ろば	名	驴子
炉端	ろばた	名	炉边、炉旁
路面	ろめん	名	路面
呂律	ろれつ	名	发音、语调
論	ろん	名	理论；；意见、见解；讨论、争辩
論外	ろんがい	名	论题之外、议论范围之外
論議	ろんぎ	名，サ変	讨论、争论
論語	ろんご	名	论语
論じる	ろんじる	他上一	论述、阐述；争论、辩论
論説	ろんせつ	名，サ変	评论、社论
論争	ろんそう	名，サ変	辩论、论战、争论、论争
論文	ろんぶん	名	论说文；论文
論理	ろんり	名	伦理、逻辑；规律、道理
輪	わ	名	圈、环；车轮；箍
和	わ	名	合计、总和；和平；和好、和睦；日本、日本式的
猥褻	わいせつ	名，形動	猥亵、淫猥
賄賂	わいろ	名	贿赂
わいわい	わいわい	副	喧哗、吵闹
和歌	わか	名	和歌
若い	わかい	形	年轻；有活力的；幼稚、未成熟；（数字、号码）小
和解	わかい	名，サ変	和好、和解；妥协
若返る	わかがえる	自五	变得年轻、返老还童
和菓子	わがし	名	日式点心
若死に	わかじに	名，サ変	短命、夭折
沸かす	わかす	他五	烧开、烧热、加热；使情绪高涨
分かつ	わかつ	他五	分享；区分、区别；分辨、辨别、判断
若作り	わかづくり	名	打扮得年轻
若手	わかて	名	年轻人
若葉	わかば	名	嫩叶、新叶
我輩	わがはい	代	（男性用语）我们
我が儘	わがまま	名，形動	任性放肆、恣意
若布	わかめ	名	裙带菜
若者	わかもの	名	年轻人、青年
我が物顔	わがものがお	名	旁若无人、傲然、唯我独尊
我が家	わがや	名	自己的家、我家
分かる，判る	わかる	自五	理解、洞察；明白、发现；知道、认知、判断；判明；懂事
別れ	わかれ	名	离别、分开、分离
分かれ目	わかれめ	名	分界点、分水岭；关键、关头
分かれる	わかれる	自下一	分歧；分开、分裂；区分；解散
別れる	わかれる	自下一	分别、分离；离婚
脇	わき	名	腋、胳肢窝；旁边、附近；别处、旁处；其他方向
和気藹々	わきあいあい	形動	和睦、和气
湧き上がる	わきあがる	自五	煮沸、煮开、滚烫；沸腾、掀起；涌现
沸き立つ	わきたつ	自五	沸腾；欢腾、狂热；轰动、骚动
弁える	わきまえる	他下一	区别、识别、判明；领会、明白、知道、懂得
脇目	わきめ	名	往别处看；旁观
脇役	わきやく	名	配角；助理
沸く	わく	自五	煮开、烧热；激动、兴奋；熔化；哄闹、叫嚷
湧く	わく	自五	涌出、冒出；发生、孽生；突然出现、涌起；产生
枠	わく	名	框、框子；边线、轮廓；界限、范围
枠組み	わくぐみ	名	框架、构架；（事物的）结构、轮廓
惑星	わくせい	名	行星；黑马、有实力而不为人知的人物
枠内	わくない	名	框子里；限度内、范围内
わくわく	わくわく	副，サ変	心情不平静
訳	わけ	名	意思；道理；理由；事由；当然；费事、麻烦；否定、断定的委婉说法；（用否定式表示）不能、不可以
分け入る	わけいる	自五	扒开进入
分け目	わけめ	名	发缝儿；关键、分界线
分ける	わける	他下一	分割、划分；分离、分开；分别、区别；分配；分让；拨开、置之不理；辨明是非
和語	わご	名	日本固有的语言；日语
業	わざ	名	工作；行为
わざと	わざと	副	故意
山葵	わさび	名	芥末
災い	わざわい	名，サ変	灾难、不幸
わざわざ	わざわざ	副	特别、特意；故意
和紙	わし	名	和纸、日本纸
わし	わし	代	我、俺
鷲	わし	名	雕、鹫
和式	わしき	名	日式
和室	わしつ	名	日式房间
和食	わしょく	名	日式饭菜
僅か	わずか	副，形動	仅、一点点；稍微、微小；仅仅；好不容易、勉强
煩い，患い	わずらい	名	苦恼、烦恼；病
煩う，患う	わずらう	自他五	烦心、苦恼；患病、生病
煩わしい	わずらわしい	形	麻烦；烦琐、复杂
煩わす	わずらわす	他五	为……苦恼、使烦恼；麻烦、烦扰
忘れ形見	わすれがたみ	名	纪念品；孤儿
忘れっぽい	わすれっぽい	形	健忘
忘れ物	わすれもの	名	遗忘的东西、遗失的东西
忘れる	わすれる	自他下一	忘记；没注意；遗落、丢下；忘却、忘怀
綿	わた	名	棉花
話題	わだい	名	话题
蟠り	わだかまり	名	反感、隔阂、芥蒂；不满、疙瘩
蟠る	わだかまる	自五	卷、盘踞；有隔阂、存在（不满）
私	わたくし	名，代	自己、我；私人
私	わたし	代	我
渡す	わたす	他五	架、跨越；渡河；交、递；给；让给
渡り	わたり	名	传来、进口；（为谋生而）奔波；鸟类季节性的迁移
渡り鳥	わたりどり	名	候鸟；到处谋生的人
渡る	わたる	自五	过河、过；渡；吹过、掠过；度日、过活；交给、归谁所有；分发到
わっしょい	わっしょい	感	嘿吆；（起哄声）嘿、噢
罠	わな	名	圈套；（诬陷人的）圈套、陷阱
鰐	わに	名	鳄鱼
詫び	わび	名	道歉
侘しい	わびしい	形	寂寞；冷清、清静；贫困、寒酸
詫びる	わびる	他上一	道歉、赔不是
和風	わふう	名	日式
和服	わふく	名	和服
和平	わへい	名	和平、和睦
喚く	わめく	自五	（大声）叫、唤、喊
藁	わら	名	稻草、麦秸；缺点
笑い	わらい	名	笑、微笑；嘲弄、嘲笑
笑い種	わらいぐさ	名	笑柄
笑いこける	わらいこける	自下一	捧腹大笑
笑い事	わらいごと	名	玩笑、可笑的事、有趣的事
笑い飛ばす	わらいとばす	他五	付之一笑、一笑了之
笑い話	わらいばなし	名	笑话
笑う	わらう	自他五	笑、微笑；嘲讽；花开、开绽
草鞋	わらじ	名	草鞋
割	わり	名	比例；百分比；比较、比；兑水、加水；分派
割合	わりあい	名，副	比率、比例；百分比；比较
割り当て	わりあて	名	分配、分摊、分担
割り当てる	わりあてる	他下一	分摊、分配、分派
割り切る	わりきる	他五	断然下结论、迅速作决定；除尽
割り切れる	わりきれる	自下一	除尽；想通、理解、接受
割り込む	わりこむ	自他五	挤进、加塞儿；插嘴
割に	わりに	副	意外、格外；比较
割引	わりびき	名，サ変	减价、打折；贴现票据；（听话）打折扣
割り引く	わりびく	他五	打折扣、削价；贴现；听话打折扣
割り振る	わりふる	他五	分派、分摊
割り前	わりまえ	名	分得的份儿
割り増し	わりまし	名	增额
割安	わりやす	名，形動	比较便宜
割る	わる	他五	破坏；分、切、割；弄破；挤进、拨开；分配；除；分裂、离间；介入；低于、少于；对、搀和；出界；终点
悪	わる	名，接頭，接尾	坏事；坏人
悪い	わるい	形	坏、不好、恶；错误、不对；恶劣、不利；不正常的；不愉快、不舒畅；有害、不利；身体不舒服、不适；不方便；不希望；对不住
悪気	わるぎ	名	恶意；歹念；坏主意
悪口	わるぐち	名	中伤、辱骂、诽谤
悪さ	わるさ	名	坏、不好、恶劣；淘气
悪者	わるもの	名	坏人、恶棍、坏蛋
我	われ	名，代	我
我勝ちに	われがちに	副	争先恐后
我知らず	われしらず	副	不知不觉地、无意识地
我ながら	われながら	副	连自己都
割れ目	われめ	名	裂纹、裂口、裂缝
割れ物	われもの	名	易碎之物
我等	われら	代	我们
割れる	われる	自下一	碎、坏了；裂开；整除；分裂；暴露、败露；声音难听、刺耳
我々	われわれ	代	我们
腕章	わんしょう	名	袖章、臂章
腕白	わんぱく	名，形動	顽皮鬼、淘气包
腕力	わんりょく	名	腕力、臂力；体力；暴力、动武
